ID,EDAD, Income ,Kidhome,Teenhome,Recency,MntWines,MntFruits,MntMeatProducts,MntFishProducts,MntSweetProducts,MntGoldProds,Mnt_SUM,NumDealsPurchases,NumWebPurchases,NumCatalogPurchases,NumStorePurchases,NumWebVisitsMonth,Num_SUM,CMP
1826,51,84835,0,0,0,189,104,379,111,189,218,1190,1,4,4,6,1,16,0
1,60,57091,0,0,0,464,5,64,7,0,37,577,1,7,3,7,5,23,1
10476,63,67267,0,1,0,134,11,59,15,2,30,251,1,3,2,5,2,13,0
1386,54,32474,1,1,0,10,0,1,0,0,0,11,1,1,0,2,7,11,0
5371,32,21474,1,0,0,6,16,24,11,0,34,91,2,3,1,2,7,15,1
7348,63,71691,0,0,0,336,130,411,240,32,43,1192,1,4,7,5,2,19,0
4073,67,63564,0,0,0,769,80,252,15,34,65,1215,1,10,10,7,6,34,1
1991,54,44931,0,1,0,78,0,11,0,0,7,96,1,2,1,3,5,12,0
4047,67,65324,0,1,0,384,0,102,21,32,5,544,3,6,2,9,4,24,0
9477,67,65324,0,1,0,384,0,102,21,32,5,544,3,6,2,9,4,24,0
2079,74,81044,0,0,0,450,26,535,73,98,26,1208,1,5,6,10,1,23,0
5642,42,62499,1,0,0,140,4,61,0,13,4,222,2,3,1,6,4,16,0
10530,62,67786,0,0,0,431,82,441,80,20,102,1156,1,3,6,6,1,17,0
2964,40,26872,0,0,0,3,10,8,3,16,32,72,1,1,1,2,6,11,0
10311,52,4428,0,1,0,16,4,12,2,4,321,359,0,25,0,0,1,26,0
837,44,54809,1,1,0,63,6,57,13,13,22,174,4,2,1,5,4,16,0
10521,44,54809,1,1,0,63,6,57,13,13,22,174,4,2,1,5,4,16,0
10175,63,32173,0,1,0,18,0,2,0,0,2,22,1,1,0,3,4,9,0
1473,61,47823,0,1,0,53,1,5,2,1,10,72,2,2,0,3,8,15,0
2795,63,30523,2,1,0,5,0,3,0,0,5,13,1,1,0,2,7,11,0
2285,67,36634,0,1,0,213,9,76,4,3,30,335,3,5,2,5,7,22,0
115,55,43456,0,1,0,275,11,68,25,7,7,393,3,5,1,8,5,22,0
10470,42,40662,1,0,0,40,2,23,0,4,23,92,2,2,1,3,4,12,0
4065,45,49544,1,0,0,308,0,73,0,0,23,404,2,5,1,8,7,23,0
10968,52,57731,0,1,0,266,21,300,65,8,44,704,4,8,8,6,6,32,0
5985,56,33168,0,1,0,80,1,37,0,1,3,122,3,2,1,4,7,17,0
5430,65,54450,1,1,0,454,0,171,8,19,32,684,12,9,2,8,8,39,0
8432,65,54450,1,1,0,454,0,171,8,19,32,684,12,9,2,8,8,39,0
453,65,35340,1,1,1,27,0,12,0,1,5,45,2,2,0,3,5,12,0
9687,46,73170,0,0,1,184,174,256,50,30,32,726,1,5,4,6,2,18,0
8890,50,65808,1,1,1,155,7,80,13,7,10,272,3,5,1,5,6,20,0
9264,35,79529,0,0,1,423,42,706,73,197,197,1638,1,4,8,9,2,24,0
5824,49,34578,2,1,1,7,0,1,0,0,0,8,1,1,0,2,6,10,0
5794,47,46374,0,1,1,408,0,21,0,0,17,446,3,7,1,7,8,26,1
3068,31,18351,0,0,1,1,12,9,0,14,7,43,1,2,0,3,7,13,0
7962,34,95169,0,0,1,1285,21,449,106,20,20,1901,1,4,3,4,1,13,1
2681,37,65370,0,0,1,71,22,112,138,89,29,461,1,2,3,13,1,20,0
10141,61,39228,0,0,1,7,1,6,0,3,3,20,1,0,0,3,4,8,0
3725,60,84865,0,0,1,1248,16,349,43,16,16,1688,1,2,4,9,4,20,1
3767,53,61314,0,1,1,378,0,189,97,172,172,1008,2,5,5,12,3,27,0
5585,49,21359,1,0,1,12,2,17,6,1,10,48,2,2,0,3,8,15,0
7030,66,66465,0,1,1,1200,0,204,38,29,14,1485,3,11,9,12,6,41,1
1524,38,81698,0,0,1,709,45,115,30,160,45,1104,1,8,2,5,5,21,1
3657,35,39146,1,0,1,94,1,33,13,12,12,165,3,4,0,4,8,19,0
5740,51,25959,1,1,1,4,2,12,7,5,26,56,2,1,2,2,6,13,0
9595,60,64260,0,0,1,539,169,816,20,0,30,1574,1,4,5,4,3,17,0
3158,48,32300,1,0,1,13,3,6,6,5,6,39,1,1,0,3,8,13,0
5114,56,74806,0,1,1,670,9,249,0,28,9,965,2,5,4,5,4,20,0
340,51,72967,0,1,1,158,35,179,0,0,125,497,2,7,2,8,5,24,1
8805,61,48904,0,1,1,283,10,38,0,13,27,371,4,7,2,4,8,25,0
1241,37,14796,1,0,1,13,3,8,7,4,16,51,2,1,0,3,9,15,0
1402,67,66991,0,0,1,496,36,460,189,60,12,1253,3,4,8,6,3,24,0
7264,43,52195,2,1,2,12,0,4,0,0,1,17,1,1,0,2,8,12,0
1619,65,90369,0,0,2,292,51,981,224,23,17,1588,1,4,6,6,1,18,0
6398,47,18393,1,0,2,7,10,13,16,0,4,50,2,3,0,3,8,16,0
1857,69,47139,1,1,2,46,0,12,0,2,23,83,2,2,1,2,7,14,0
4877,48,38576,0,1,2,34,0,7,0,0,0,41,1,1,0,3,7,12,0
3066,46,61905,0,1,2,167,0,43,6,2,13,231,2,4,2,4,5,17,0
10286,59,83715,0,0,2,318,8,407,150,35,8,926,1,2,8,13,0,24,0
1992,57,60597,0,1,2,522,0,257,32,16,66,893,4,2,2,8,7,23,1
4246,39,6560,0,0,2,67,11,26,4,3,262,373,0,1,0,1,17,19,0
10623,60,48330,0,1,2,28,0,4,0,0,0,32,1,1,0,3,5,10,0
4867,53,38236,1,1,2,58,0,18,2,0,10,88,4,3,0,4,7,18,0
3112,44,22701,1,0,2,2,4,9,0,4,5,24,1,1,0,3,5,10,0
4865,47,53367,1,1,2,229,7,140,10,3,11,400,7,5,1,8,7,28,0
6287,35,34728,1,0,2,14,0,16,0,0,6,36,1,1,1,2,6,11,0
4405,65,63915,0,2,2,622,7,115,30,0,15,789,2,6,3,12,5,28,0
5332,61,82504,0,0,2,362,50,431,134,35,54,1066,1,3,6,7,1,18,0
1519,49,38578,1,1,2,38,4,22,3,3,3,73,3,3,0,3,8,17,0
9080,49,38578,1,1,2,38,4,22,3,3,3,73,3,3,0,3,8,17,0
1772,46,79174,0,0,2,1074,37,518,193,92,129,2043,1,5,6,7,2,21,1
5341,59,81975,0,1,2,983,76,184,180,138,27,1588,1,6,3,4,7,21,1
5510,44,43263,0,1,2,262,6,61,0,10,102,441,3,5,2,6,5,21,0
3887,51,27242,1,0,2,3,17,26,20,1,39,106,2,2,0,3,9,16,0
7022,50,76445,1,0,2,739,107,309,140,80,35,1410,1,2,5,13,6,27,0
9999,56,75276,0,0,2,610,105,125,137,42,21,1040,1,9,4,9,5,28,0
10352,58,34213,1,1,2,50,4,28,6,3,26,117,3,3,1,2,9,18,0
7919,45,72335,0,0,2,1285,105,653,28,21,0,2092,1,10,4,8,8,31,0
4114,57,79143,0,0,2,650,37,780,27,167,32,1693,1,6,9,13,3,32,0
7990,74,27469,0,0,2,9,1,2,3,2,0,17,1,0,0,3,6,10,0
9888,52,68695,0,0,3,458,81,356,106,50,40,1091,1,4,4,7,2,18,0
4399,52,68695,0,0,3,458,81,356,106,50,40,1091,1,4,4,7,2,18,0
4452,64,50388,0,1,3,292,6,37,0,3,34,372,4,6,1,6,7,24,1
4785,51,77622,0,2,3,520,7,154,19,0,14,714,2,6,3,11,3,25,0
8461,59,46102,2,1,3,14,0,1,0,0,1,16,1,1,0,2,7,11,0
3878,41,31859,1,0,3,3,4,7,15,8,11,48,1,1,0,3,7,12,0
9612,34,23830,0,0,3,1,8,6,4,8,16,43,1,1,0,3,7,12,0
4098,48,24639,1,1,3,20,3,16,0,4,1,44,3,2,0,4,6,15,0
158,76,71604,0,0,3,345,53,528,98,75,97,1196,1,8,3,5,4,21,1
3896,37,27255,1,0,3,22,1,11,0,1,2,37,1,1,0,3,7,12,0
9970,44,55375,0,1,3,42,11,57,10,28,14,162,1,1,1,6,2,11,0
4002,61,77037,0,1,3,463,96,333,168,53,10,1123,1,7,7,12,3,30,0
10914,51,24163,1,1,3,4,1,7,2,1,2,17,2,1,0,3,4,10,0
7279,52,69476,0,0,3,260,86,559,63,9,67,1044,1,4,6,4,2,17,0
10582,42,72063,0,1,3,180,32,348,76,32,90,758,2,5,2,12,2,23,0
4470,59,58646,0,1,3,62,1,44,6,5,22,140,1,2,1,4,4,12,0
6183,59,58646,0,1,3,62,1,44,6,5,22,140,1,2,1,4,4,12,0
6379,72,47570,1,1,3,67,1,20,0,2,31,121,3,2,2,2,7,16,0
8601,41,80011,0,1,3,421,76,536,82,178,102,1395,2,8,6,5,4,25,0
4827,65,54998,0,1,3,154,22,202,39,30,8,455,5,4,2,9,4,24,0
6715,73,60200,0,1,3,502,19,132,0,6,26,685,6,6,2,11,6,31,0
10676,39,63211,0,0,3,145,193,459,205,26,145,1173,2,3,8,7,2,22,0
1041,48,48432,0,1,3,322,3,50,4,3,42,424,5,7,1,6,8,27,0
492,48,48432,0,1,3,322,3,50,4,3,42,424,5,7,1,6,8,27,0
11133,48,48432,0,1,3,322,3,50,4,3,42,424,5,7,1,6,8,27,0
4491,72,62845,1,1,3,1099,0,45,0,0,34,1178,11,3,4,10,8,36,1
873,72,62845,1,1,3,1099,0,45,0,0,34,1178,11,3,4,10,8,36,1
1631,56,65220,0,0,3,890,63,292,0,25,12,1282,4,8,4,7,6,29,0
8278,31,74214,0,0,3,863,83,547,86,99,33,1711,1,8,2,5,5,21,0
6815,41,96547,0,0,4,448,21,125,52,101,62,809,0,7,6,8,2,23,1
254,66,53863,0,1,4,399,4,30,6,4,30,473,3,7,1,7,7,25,1
1349,51,50447,2,0,4,85,7,24,2,3,27,148,1,3,1,3,6,14,0
2534,68,37716,0,1,4,97,1,41,6,2,41,188,2,4,1,3,7,17,0
2130,39,45203,2,0,4,35,3,67,10,8,24,147,1,3,1,3,6,14,0
2296,46,37368,1,0,4,3,2,11,2,2,10,30,1,1,0,2,6,10,1
3799,66,67225,0,1,4,315,35,322,46,7,143,868,3,7,2,11,5,28,0
11084,45,65104,0,1,4,738,0,232,13,20,50,1053,2,3,5,7,7,24,0
5172,45,65104,0,1,4,738,0,232,13,20,50,1053,2,3,5,7,7,24,0
9504,72,81698,0,0,4,179,28,520,111,123,47,1008,1,3,8,13,1,26,0
850,53,70566,0,1,4,381,28,215,84,28,21,757,2,6,5,9,3,25,0
4477,63,69096,0,1,4,247,49,159,7,82,109,653,1,5,2,10,4,22,0
1945,59,71434,0,1,4,711,36,217,172,96,168,1400,3,7,4,7,4,25,1
7685,43,33039,1,0,4,30,8,12,8,8,12,78,1,2,0,4,5,12,0
6310,43,33039,1,0,4,30,8,12,8,8,12,78,1,2,0,4,5,12,0
10832,63,46610,0,0,4,288,10,30,4,10,125,467,1,6,1,6,6,20,0
3025,63,49967,0,1,4,212,6,69,4,12,3,306,3,6,1,5,7,22,0
2404,45,53359,1,1,4,173,4,30,3,6,41,257,4,5,1,4,7,21,0
8581,50,49505,1,1,4,604,0,100,19,0,28,751,9,10,2,8,8,37,0
8755,75,68657,0,0,4,482,34,471,119,68,22,1196,1,3,5,9,7,25,0
10177,67,72071,0,1,4,531,69,300,150,138,150,1338,3,5,4,8,2,22,0
2429,67,72071,0,1,4,531,69,300,150,138,150,1338,3,5,4,8,2,22,0
8920,54,59235,1,0,4,448,40,469,80,0,91,1128,3,11,2,12,7,35,0
8430,64,21994,0,1,4,9,0,6,3,1,3,22,1,0,0,3,5,9,0
8619,64,21994,0,1,4,9,0,6,3,1,3,22,1,0,0,3,5,9,0
7233,49,69209,0,0,4,496,32,849,229,48,128,1782,2,5,3,6,4,20,1
6678,32,31928,1,0,5,33,4,24,4,2,5,72,2,3,0,4,7,16,0
830,34,74004,0,0,5,784,48,560,42,176,48,1658,1,4,6,4,3,18,1
6365,34,30390,0,0,5,10,12,12,25,1,20,80,1,2,0,3,6,12,0
6770,36,21355,1,0,5,5,13,14,0,5,31,68,2,2,1,2,6,13,1
2261,52,26304,1,0,5,4,1,5,2,0,4,16,1,1,0,2,7,11,0
1031,32,85710,0,0,5,600,20,350,29,30,33,1062,1,6,9,10,2,28,1
10089,47,102692,0,0,5,168,148,444,32,172,148,1112,1,6,9,13,2,31,1
9256,50,58350,0,1,5,493,26,206,116,80,80,1001,4,8,3,12,6,33,0
10641,43,7500,1,1,5,6,5,4,13,4,25,57,4,2,1,3,6,16,0
624,37,18890,0,0,5,6,4,1,7,2,15,35,1,0,1,2,6,10,1
4211,35,20425,1,0,5,4,12,5,3,16,17,57,2,2,0,3,7,14,0
1407,35,20425,1,0,5,4,12,5,3,16,17,57,2,2,0,3,7,14,0
10356,64,41437,1,1,5,29,0,2,0,0,1,32,1,1,0,3,7,12,0
9323,72,49912,0,1,5,520,8,223,32,49,42,874,4,10,5,7,8,34,1
1146,72,49912,0,1,5,520,8,223,32,49,42,874,4,10,5,7,8,34,1
6343,62,79823,0,1,6,835,73,380,114,73,43,1518,1,6,9,7,2,25,1
8545,67,85683,0,0,6,1296,17,311,45,69,51,1789,1,2,4,10,1,18,1
8275,56,47025,1,1,6,16,0,3,0,0,1,20,1,1,0,2,7,11,0
10673,45,68397,0,1,6,760,80,466,17,13,80,1416,1,6,9,5,3,24,0
8799,37,38175,1,0,6,70,6,69,2,3,3,153,3,3,1,4,7,18,0
67,49,46423,1,1,6,68,0,16,0,0,8,92,3,2,0,4,7,16,0
9923,49,46423,1,1,6,68,0,16,0,0,8,92,3,2,0,4,7,16,0
2814,45,30560,1,0,6,9,1,5,4,5,7,31,1,1,0,3,7,12,0
2711,45,30560,1,0,6,9,1,5,4,5,7,31,1,1,0,3,7,12,0
4320,42,60152,0,1,6,325,83,300,86,58,91,943,1,6,4,12,3,26,0
10451,56,29672,1,1,6,9,1,3,0,4,8,25,1,0,0,3,6,10,0
4198,56,29672,1,1,6,9,1,3,0,4,8,25,1,0,0,3,6,10,0
10814,74,70321,0,0,6,303,23,751,82,26,191,1376,1,6,5,13,4,29,0
944,59,56181,0,1,6,121,103,69,8,44,48,393,1,4,2,7,4,18,0
8151,31,24279,0,0,6,16,36,21,20,62,108,263,1,4,1,3,8,17,0
6184,52,68462,0,0,6,561,64,785,84,128,48,1670,1,3,3,8,1,16,0
3498,45,55424,0,1,6,462,61,184,10,53,107,877,4,7,5,9,6,31,1
2870,48,49094,0,1,6,376,0,38,11,8,69,502,5,6,3,6,6,26,0
7342,60,59184,0,1,6,341,142,113,259,151,66,1072,3,6,6,12,5,32,0
1911,34,67430,0,0,6,595,97,291,127,133,121,1364,1,11,5,12,6,35,0
10862,61,30522,0,1,6,179,8,83,19,11,26,326,5,1,2,9,2,19,0
2546,44,31878,0,1,7,23,4,5,10,5,23,70,1,1,0,4,3,9,0
3005,29,83528,0,0,7,530,117,678,134,44,147,1650,1,4,10,8,1,24,1
8318,42,90300,0,0,7,594,134,786,33,134,57,1738,0,5,6,8,1,20,1
2930,43,68092,0,0,7,852,60,207,78,36,48,1281,2,2,6,10,5,25,0
8216,49,53761,1,1,7,158,0,76,13,7,71,325,6,4,4,3,5,22,0
1212,48,52845,1,0,7,384,25,292,130,41,64,936,3,8,8,6,6,31,1
2541,45,24027,1,0,7,14,7,11,11,0,5,48,2,2,0,3,8,15,0
10659,42,7500,1,0,7,2,8,11,3,8,21,53,4,3,2,2,7,18,0
10905,66,42586,1,1,7,194,2,56,0,0,0,252,5,4,1,6,8,24,0
8910,66,42586,1,1,7,194,2,56,0,0,0,252,5,4,1,6,8,24,0
7349,48,9722,1,0,7,6,17,16,6,16,42,103,4,3,1,3,8,19,0
7872,46,86836,0,0,7,179,21,273,0,21,63,557,1,6,10,6,5,28,1
4290,49,30467,1,0,8,1,3,8,2,5,5,24,1,1,0,2,7,11,0
7408,69,54549,0,1,8,216,2,6,0,0,9,233,2,5,1,4,7,19,0
9986,39,19444,1,0,8,16,0,23,3,2,10,54,3,4,1,2,7,17,0
8235,65,69245,0,1,8,428,30,214,80,30,61,843,2,6,5,10,3,26,0
10949,58,72968,0,0,8,1092,37,592,145,37,55,1958,1,5,5,8,3,22,1
7284,68,48686,1,2,8,10,0,7,2,0,1,20,1,1,0,2,8,12,0
9529,31,73687,0,0,8,559,153,503,218,13,181,1627,1,3,9,9,2,24,1
9930,77,82716,0,0,8,606,148,228,15,148,22,1167,1,6,8,13,2,30,0
10270,40,35523,1,0,8,11,5,22,12,5,11,66,2,3,0,3,7,15,0
760,46,60554,1,0,8,588,7,76,110,15,15,811,2,8,4,9,6,29,0
5519,65,64090,0,1,8,316,58,161,76,51,135,797,1,6,9,4,5,25,0
232,56,61559,0,1,8,279,83,88,32,14,34,530,1,4,2,10,3,20,0
3009,59,71670,0,0,8,1462,16,128,0,0,160,1766,1,5,3,6,6,21,1
6518,70,67680,0,1,8,546,0,48,0,6,6,606,1,7,3,8,5,24,0
10669,40,54386,0,1,8,277,21,64,62,21,25,470,2,3,2,10,3,20,0
5682,68,64108,0,1,8,948,10,86,13,21,21,1099,4,6,9,11,5,35,0
1570,70,69702,0,1,8,664,9,240,50,19,57,1039,2,7,7,10,4,30,0
1497,69,47958,0,1,8,268,11,88,15,3,22,407,2,6,3,5,5,21,0
9723,61,67716,0,1,8,530,142,217,62,9,56,1016,4,7,4,13,5,33,1
7261,50,34600,1,1,8,199,33,60,8,3,15,318,5,5,2,5,8,25,0
2452,50,34600,1,1,8,199,33,60,8,3,15,318,5,5,2,5,8,25,0
5621,52,48752,1,1,8,73,57,100,71,15,0,316,5,6,1,5,9,26,0
10995,33,15716,1,0,8,16,5,30,8,7,26,92,3,3,0,4,8,18,0
7373,69,46610,0,2,8,96,12,96,33,22,43,302,6,4,1,6,6,23,0
5331,44,74985,0,0,8,587,51,898,247,0,86,1869,1,3,6,7,2,19,0
263,76,45576,0,0,9,56,19,29,2,14,25,145,1,3,1,3,8,16,0
4619,76,113734,0,0,9,6,2,3,1,262,3,277,0,27,0,0,1,28,0
940,34,57100,1,0,9,158,11,99,15,11,17,311,2,3,2,7,3,17,0
10084,49,24434,2,0,9,3,2,8,20,0,17,50,2,2,1,2,7,14,0
6019,50,37126,1,0,9,45,3,9,4,4,7,72,1,1,2,2,6,12,1
1463,63,45160,1,1,9,8,2,5,3,0,3,21,1,1,0,2,7,11,0
6424,44,33178,1,0,9,12,6,2,11,2,16,49,1,1,0,3,4,9,0
8233,71,64866,0,1,9,508,5,21,7,5,10,556,4,7,3,7,5,26,1
1515,46,34176,0,1,9,11,2,7,4,2,2,28,1,1,0,3,3,8,0
10855,53,50014,1,0,9,234,14,77,19,10,42,396,2,4,1,8,5,20,0
10909,73,92344,0,0,9,992,24,694,51,19,119,1899,0,5,10,5,1,21,1
3376,51,55282,1,0,9,125,6,73,8,4,19,235,1,3,1,6,4,15,0
10232,58,48799,0,1,9,174,18,81,28,6,24,331,3,3,2,7,3,18,0
5547,39,84169,0,0,9,1478,19,403,0,19,0,1919,1,7,6,6,3,23,1
8362,39,84169,0,0,9,1478,19,403,0,19,0,1919,1,7,6,6,3,23,1
3524,50,39763,1,0,9,80,1,60,4,6,16,167,2,5,1,2,9,19,0
10095,46,74165,0,0,9,1001,12,240,16,12,12,1293,1,5,4,10,2,22,0
8897,56,42720,1,1,9,392,5,91,28,26,112,654,8,7,3,7,8,33,0
466,77,65275,0,0,9,388,14,218,91,14,21,746,1,4,3,13,2,23,0
11025,60,36443,1,1,9,65,0,46,4,3,20,138,4,3,1,3,8,19,0
2387,69,43776,1,1,9,177,2,71,3,2,20,275,6,5,2,4,8,25,0
1618,56,56046,0,0,9,577,0,64,0,0,51,692,2,10,1,8,8,29,1
25,63,65148,0,1,9,460,35,422,33,12,153,1115,2,6,6,7,4,25,0
3277,66,49431,0,1,9,219,3,100,26,0,17,365,2,7,1,5,8,23,0
8566,60,32583,1,1,10,5,0,3,0,0,1,9,1,1,0,2,7,11,0
2634,42,16653,1,0,10,5,7,31,15,4,7,69,3,2,1,3,6,15,0
8036,50,26850,1,1,10,31,1,13,7,2,9,63,4,2,1,4,4,15,0
8159,53,51287,1,1,10,117,0,22,13,0,30,182,3,4,1,3,7,18,0
7628,48,43050,1,0,10,30,5,24,6,3,8,76,2,2,0,4,5,13,0
9597,52,73448,0,0,10,236,106,189,23,41,130,725,1,7,2,9,4,23,0
1384,29,17256,1,0,10,6,4,14,8,8,22,62,2,2,1,2,8,15,1
10150,60,86429,0,0,10,464,28,873,29,18,37,1449,0,7,4,7,2,20,1
3885,38,33569,1,0,10,16,2,18,3,0,24,63,1,1,1,2,8,13,1
11003,41,25130,1,0,10,2,5,7,0,18,18,50,2,2,0,3,7,14,0
8026,69,62998,0,1,10,120,58,73,65,89,58,463,5,5,4,5,5,24,0
577,45,26907,1,1,10,9,1,7,0,3,2,22,2,1,0,3,7,13,0
8702,45,26907,1,1,10,9,1,7,0,3,2,22,2,1,0,3,7,13,0
5429,73,45579,0,1,10,145,1,33,2,1,1,183,1,4,1,4,6,16,0
977,64,47320,0,1,10,200,19,111,50,15,19,414,6,5,1,8,6,26,0
2793,45,70179,0,1,10,532,88,168,69,44,133,1034,3,7,3,13,5,31,0
1071,45,70179,0,1,10,532,88,168,69,44,133,1034,3,7,3,13,5,31,0
5074,35,28072,1,0,10,30,0,10,2,0,5,47,1,1,0,3,7,12,0
2632,67,50501,1,1,10,297,0,38,13,0,152,500,7,5,4,4,6,26,1
6404,52,58917,1,2,10,151,7,89,0,7,28,282,5,4,1,6,5,21,0
10240,72,69372,0,0,10,997,26,269,34,13,42,1381,1,10,4,6,4,25,1
2521,50,35178,1,0,10,23,1,13,2,2,18,59,1,1,1,2,7,12,1
4301,50,35178,1,0,10,23,1,13,2,2,18,59,1,1,1,2,7,12,1
7381,53,75693,0,0,10,797,153,293,72,97,30,1442,1,11,4,6,4,26,1
2407,39,69109,0,0,10,823,25,459,124,29,95,1555,1,6,6,7,4,24,1
9064,39,69109,0,0,10,823,25,459,124,29,95,1555,1,6,6,7,4,24,1
5067,27,80134,0,0,11,966,26,282,52,26,26,1378,1,2,7,11,5,26,1
10281,51,64713,1,0,11,180,60,241,13,54,54,602,2,5,5,7,4,23,0
11191,35,41411,0,0,11,37,32,38,11,3,18,139,1,2,1,4,6,14,0
2552,66,55521,1,2,11,416,0,26,0,0,4,446,9,6,3,6,7,31,1
6720,53,43795,0,1,11,314,11,53,4,3,107,492,3,7,3,4,7,24,1
4557,51,22070,1,0,11,10,7,19,8,2,21,67,2,2,2,2,6,14,0
1183,72,36408,1,1,11,9,1,4,3,2,3,22,1,1,0,2,6,10,0
4186,71,34026,1,1,11,18,6,15,12,8,17,76,3,2,1,3,5,14,0
1419,71,34026,1,1,11,18,6,15,12,8,17,76,3,2,1,3,5,14,0
967,45,46049,1,1,11,342,9,112,19,14,19,515,10,5,2,9,7,33,0
1048,49,35641,1,0,11,63,3,67,8,9,28,178,2,3,1,4,7,17,0
9262,37,32414,0,0,11,20,6,5,0,9,12,52,1,1,0,3,7,12,1
3427,66,59821,0,1,11,629,0,70,0,0,35,734,6,11,2,7,8,34,0
5892,41,34968,1,0,11,158,6,45,8,2,2,221,7,3,2,5,7,24,0
8911,54,56320,0,1,11,201,53,172,116,77,83,702,3,5,4,9,4,25,0
6606,52,70091,1,0,11,964,34,137,15,0,11,1161,2,5,2,10,8,27,1
2677,65,46097,0,1,11,72,24,68,65,4,8,241,5,3,1,6,4,19,0
252,58,41003,0,0,11,123,133,142,71,44,88,601,1,6,2,8,6,23,0
9860,62,44911,0,1,11,159,0,22,2,1,31,215,3,4,1,4,7,19,0
1388,46,33249,1,0,11,6,10,21,19,14,42,112,2,2,1,3,6,14,0
979,46,33249,1,0,11,6,10,21,19,14,42,112,2,2,1,3,6,14,0
7494,71,42873,1,1,11,209,0,40,3,2,15,269,4,6,1,4,8,23,0
10490,52,51039,1,1,11,100,64,79,65,0,109,417,2,6,2,4,7,21,0
3403,63,78952,0,1,11,1170,19,594,99,76,134,2092,2,2,5,12,6,27,0
2715,55,29435,1,1,11,70,3,37,4,2,64,180,4,3,2,2,9,20,0
4828,67,79865,0,1,12,71,99,278,185,121,38,792,1,5,10,5,1,22,0
92,33,34176,1,0,12,5,7,24,19,14,20,89,4,3,0,4,6,17,0
3312,33,34176,1,0,12,5,7,24,19,14,20,89,4,3,0,4,6,17,0
11176,51,65968,0,1,12,376,9,83,19,4,4,495,2,5,4,7,3,21,0
1446,65,86424,0,0,12,387,68,569,89,45,68,1226,1,6,9,12,1,29,0
9699,55,67272,0,1,12,357,35,271,28,28,14,733,3,6,2,12,5,28,0
9790,64,78499,0,0,12,912,72,170,47,36,97,1334,1,11,3,4,4,23,1
2324,49,77044,0,1,12,625,38,242,50,34,76,1065,2,7,11,11,4,35,1
5080,28,70515,0,0,12,420,0,452,182,64,140,1258,1,6,6,4,2,19,0
4992,46,17459,1,0,12,6,4,16,3,10,30,69,3,3,1,2,7,16,0
7849,51,80336,0,0,12,209,19,456,160,142,66,1052,1,2,9,13,1,26,0
4808,65,15759,0,0,12,1,2,5,6,0,3,17,1,1,0,2,7,11,0
10401,45,26326,0,0,12,1,0,5,0,3,9,18,1,0,0,3,3,7,0
7793,45,62061,0,1,12,641,7,84,0,30,38,800,3,10,4,7,6,30,1
9303,45,5305,0,1,12,12,4,7,1,3,5,32,0,1,0,0,13,14,0
6853,39,75777,0,0,12,712,26,538,69,13,80,1438,1,3,6,11,1,22,1
7366,39,75777,0,0,12,712,26,538,69,13,80,1438,1,3,6,11,1,22,1
9780,50,71499,0,1,12,465,25,132,136,0,37,795,2,8,3,13,4,30,0
7573,43,31626,1,0,12,39,1,9,2,1,34,86,1,2,1,2,7,13,1
1379,29,42670,0,0,12,154,2,46,20,4,15,241,1,4,2,4,4,15,0
8923,48,83917,0,0,12,514,22,732,42,198,79,1587,1,6,7,7,3,24,0
3547,52,41021,1,0,12,14,7,9,6,16,12,64,2,2,0,3,6,13,0
8707,65,79456,0,0,12,565,42,548,64,83,99,1401,1,5,6,4,3,19,0
1891,41,78789,0,0,12,667,50,850,21,83,83,1754,1,4,6,5,2,18,0
6271,69,50870,0,1,13,53,0,8,0,0,2,63,1,2,0,3,5,11,0
9635,38,35876,0,0,13,66,2,40,4,3,14,129,1,3,1,3,6,14,0
9727,64,23539,0,0,13,4,24,11,16,1,25,81,1,2,0,4,6,13,0
6205,54,32557,1,0,13,34,3,29,0,4,10,80,3,2,1,3,5,14,0
10681,51,62466,0,1,13,129,129,259,168,121,83,889,5,6,3,12,4,30,0
5156,51,62466,0,1,13,129,129,259,168,121,83,889,5,6,3,12,4,30,0
3050,55,54198,1,1,13,185,0,28,3,2,17,235,6,3,1,6,4,20,0
8164,43,82170,0,0,13,1023,93,651,49,55,37,1908,1,5,6,7,2,21,0
5626,57,61798,0,0,13,338,4,89,11,8,13,463,1,4,2,9,4,20,0
7600,29,15253,1,0,13,1,3,3,8,1,13,29,2,1,0,3,7,13,0
6406,33,78285,0,0,13,647,107,391,175,67,40,1427,1,6,4,10,3,24,0
7002,66,62535,0,1,13,163,48,90,0,45,52,398,1,3,2,8,3,17,0
8234,48,27190,1,0,13,1,6,7,0,1,3,18,1,1,0,2,8,12,1
6116,53,48985,0,1,13,19,13,18,10,7,8,75,1,1,1,3,3,9,0
291,51,72940,0,0,13,182,74,298,162,149,116,981,1,3,3,6,1,14,0
8779,36,36145,1,0,13,56,4,76,17,1,18,172,4,4,1,3,9,21,1
4931,44,157146,0,0,13,1,0,1725,2,1,1,1730,0,0,28,0,1,29,0
1650,61,81843,0,0,13,779,86,537,34,69,138,1643,1,5,9,12,3,30,0
9701,33,41883,1,0,13,32,34,41,73,16,116,312,3,4,2,3,7,19,0
6431,57,45759,1,1,13,42,1,18,3,0,4,68,2,2,0,3,7,14,0
10789,57,45759,1,1,13,42,1,18,3,0,4,68,2,2,0,3,7,14,0
5302,35,78394,0,0,13,298,27,697,216,24,166,1428,1,4,6,5,2,18,0
4459,32,30279,1,0,13,10,4,14,4,4,1,37,1,1,0,3,8,13,0
10642,32,30279,1,0,13,10,4,14,4,4,1,37,1,1,0,3,8,13,0
9213,51,31880,1,0,13,4,1,5,2,0,3,15,1,1,0,2,8,12,0
3678,48,60208,1,1,13,488,23,71,15,0,59,656,11,8,3,7,7,36,1
3698,38,78687,0,0,13,817,185,687,145,55,241,2130,1,4,6,8,2,21,1
5929,48,37401,1,0,14,19,3,19,3,1,3,48,2,2,0,3,7,14,0
10795,48,37401,1,0,14,19,3,19,3,1,3,48,2,2,0,3,7,14,0
4390,67,75315,0,1,14,459,15,171,142,23,31,841,2,5,4,12,2,25,0
9362,56,69263,0,1,14,492,5,32,13,5,21,568,1,9,1,7,6,24,1
1577,75,78569,0,0,14,558,79,622,207,175,95,1736,1,4,6,4,1,16,1
4609,55,57705,0,1,14,383,0,53,6,4,40,486,3,8,1,6,6,24,0
7143,66,74805,0,1,14,209,162,209,41,162,37,820,5,4,7,10,2,28,0
1729,60,66426,0,1,14,1043,24,97,32,24,157,1377,2,3,5,10,6,26,0
10664,72,51529,0,1,14,400,4,35,6,0,22,467,2,9,1,5,8,25,0
5029,75,18100,0,0,14,3,1,2,4,3,1,14,1,0,0,3,5,9,0
10507,44,59601,0,1,14,691,7,69,0,7,23,797,4,2,2,7,8,23,1
3865,44,20981,0,0,14,2,12,10,6,13,30,73,1,3,1,2,8,15,0
6982,45,74068,0,0,14,783,30,537,140,76,15,1581,1,4,10,9,2,26,0
7042,38,36790,0,0,14,3,3,14,15,21,10,66,1,2,1,2,9,15,0
9668,50,18793,1,0,14,4,16,20,0,17,20,77,3,2,0,4,8,17,0
6878,67,27421,0,0,14,43,12,96,78,40,55,324,3,4,1,6,7,21,0
4099,49,30675,1,0,14,10,2,16,11,2,21,62,1,1,0,3,8,13,0
5031,47,83145,0,0,14,777,35,731,39,137,114,1833,1,5,9,11,2,28,1
1970,53,34053,0,1,14,63,0,21,7,0,12,103,1,3,0,3,8,15,0
5726,38,31788,1,0,15,16,7,23,0,8,6,60,3,3,0,4,5,15,0
5231,47,45894,0,2,15,27,2,7,0,2,13,51,1,1,0,3,5,10,0
1307,43,41986,0,1,15,27,5,8,8,3,12,63,3,3,0,4,4,14,0
10609,59,42769,0,1,15,71,0,13,3,1,0,88,2,1,1,4,4,12,0
5782,39,58582,0,1,15,402,35,106,101,77,42,763,2,9,2,9,5,27,1
7533,57,49096,1,1,15,144,1,32,2,1,7,187,4,4,1,4,7,20,0
9493,41,76412,0,0,15,840,53,804,23,71,17,1808,1,5,4,8,3,21,1
2253,31,18929,0,0,15,32,0,8,23,4,18,85,1,1,0,4,6,12,0
2326,31,18929,0,0,15,32,0,8,23,4,18,85,1,1,0,4,6,12,0
1876,31,18929,0,0,15,32,0,8,23,4,18,85,1,1,0,4,6,12,0
7141,35,21888,1,0,15,88,10,46,2,3,64,213,4,5,1,2,10,22,0
7393,43,41580,1,1,15,56,5,24,4,0,3,92,3,2,1,3,5,14,0
4713,42,31605,1,0,15,74,0,42,2,1,6,125,2,2,1,4,7,16,0
5093,47,25509,1,0,15,40,3,30,10,7,11,101,3,3,0,3,9,18,0
8524,47,25509,1,0,15,40,3,30,10,7,11,101,3,3,0,3,9,18,0
3766,62,33051,0,0,15,100,71,243,108,94,219,835,3,9,1,8,9,30,0
9725,55,28764,1,1,16,8,0,3,0,0,1,12,1,1,0,2,8,12,1
8933,38,32146,1,0,16,26,3,23,4,7,3,66,2,2,0,4,6,14,0
10779,38,22148,0,0,16,15,5,14,0,4,11,49,1,1,0,3,7,12,0
9289,42,36781,1,0,16,29,1,17,0,3,13,63,1,2,1,2,8,14,0
2613,61,54197,0,1,16,162,6,37,6,13,13,237,2,1,3,6,1,13,0
10133,51,93790,0,0,16,1302,68,731,89,114,45,2349,0,6,7,12,2,27,1
8443,49,24762,1,0,16,6,10,12,3,15,40,86,3,3,1,2,8,17,1
10796,37,30477,1,0,16,47,1,6,0,0,12,66,1,1,1,3,6,12,0
10241,46,11448,0,0,16,0,0,0,6,2,6,14,1,1,0,2,6,10,0
3388,54,70844,1,1,16,129,26,67,3,67,2,294,5,6,1,5,7,24,0
6507,41,30828,1,0,16,16,11,15,2,0,12,56,2,1,1,4,3,11,0
7446,54,62513,0,1,16,520,42,98,0,42,14,716,2,6,4,10,6,28,0
87,40,27733,1,0,16,0,7,5,26,2,17,57,2,2,0,3,7,14,0
10477,48,39435,1,0,16,71,0,18,0,0,13,102,1,3,1,2,7,14,0
6072,51,75345,0,0,16,918,57,842,99,38,133,2087,1,5,8,6,3,23,1
2518,35,20491,0,0,16,5,4,5,4,2,10,30,1,0,1,2,7,11,0
247,50,36715,1,0,16,172,10,125,21,13,16,357,6,7,2,4,9,28,0
9463,62,71706,0,1,16,931,56,253,91,98,14,1443,4,9,5,7,5,30,0
1459,55,69063,0,1,16,666,35,124,69,8,26,928,1,5,3,5,3,17,0
9530,33,24645,1,0,16,5,3,4,4,1,0,17,1,1,0,2,8,12,0
9653,46,35797,0,1,16,27,1,14,4,1,21,68,2,2,0,3,8,15,0
10785,52,44078,1,1,17,24,1,10,2,0,4,41,2,2,0,3,5,12,0
9392,50,26954,1,0,17,4,1,11,0,0,1,17,1,1,0,2,7,11,0
10146,49,38887,1,0,17,25,1,13,0,0,3,42,1,1,0,3,7,12,0
4741,47,65463,1,0,17,391,32,70,21,32,16,562,2,6,2,9,5,24,1
1880,62,53537,1,1,17,81,0,6,0,0,6,93,2,2,1,3,5,13,0
6471,50,36230,1,0,17,14,2,30,8,2,3,59,1,2,0,4,5,12,0
5718,71,80763,0,0,17,674,168,108,192,42,231,1415,1,5,11,6,3,26,1
3478,50,60585,1,1,17,267,42,309,55,42,21,736,10,7,4,9,5,35,0
7848,47,49166,0,1,17,224,2,25,7,0,110,368,2,5,3,3,6,19,0
7999,66,75261,0,0,17,1239,17,413,23,34,17,1743,1,5,6,5,2,19,1
11101,30,89891,0,0,17,412,22,132,59,28,183,836,1,11,6,8,4,30,1
9212,59,72828,0,1,17,1205,0,235,19,14,205,1678,6,6,3,13,7,35,0
10983,69,75278,0,0,17,304,98,230,150,74,74,930,1,6,3,13,3,26,0
3629,43,38557,1,0,17,76,3,31,4,4,27,145,2,3,1,3,7,16,0
4673,58,81300,0,1,17,1004,12,145,32,12,36,1241,3,10,3,5,5,26,1
796,56,60161,0,1,17,584,44,212,46,8,177,1071,3,11,4,8,8,34,0
618,44,69389,0,1,17,422,7,238,69,46,15,797,1,7,2,12,4,26,0
380,67,64497,0,1,17,1170,48,320,42,32,192,1804,5,11,4,9,8,37,1
1092,41,61014,0,1,17,269,129,495,182,43,29,1147,4,9,3,4,7,27,0
8962,46,44319,1,1,18,26,0,8,0,0,3,37,2,2,0,3,5,12,0
8207,64,53233,0,1,18,28,0,9,3,0,0,40,1,1,0,3,4,9,0
6521,67,77972,0,0,18,613,22,319,33,102,12,1101,1,4,6,9,1,21,0
535,34,81361,0,0,18,163,23,424,27,65,76,778,1,3,10,13,1,28,0
4608,34,81361,0,0,18,163,23,424,27,65,76,778,1,3,10,13,1,28,0
11086,37,25707,1,0,18,1,6,2,3,6,3,21,1,1,0,3,7,12,0
1064,50,42403,1,0,18,22,1,11,0,5,3,42,1,1,0,3,8,13,0
7000,49,65704,0,0,18,279,172,74,38,8,246,817,1,2,10,10,1,24,0
1581,41,37406,1,0,18,2,0,8,2,2,3,17,1,1,0,2,8,12,0
7384,70,39767,0,0,18,113,61,204,34,26,47,485,2,7,1,7,8,25,0
10552,42,54210,0,1,18,70,54,109,80,9,45,367,2,4,1,7,5,19,0
6409,54,57136,0,0,18,267,140,599,34,12,127,1179,1,7,5,7,6,26,0
9507,46,40794,0,1,18,261,23,73,4,23,50,434,2,6,3,5,7,23,0
9560,56,83003,0,0,18,856,61,570,40,25,122,1674,1,7,6,8,3,25,1
10991,61,89058,0,0,18,454,194,106,31,22,43,850,1,5,4,4,2,16,0
4712,30,20193,0,0,18,8,8,22,24,11,9,82,1,1,1,4,4,11,0
11056,47,72099,0,0,18,546,91,410,119,0,22,1188,1,3,4,10,1,19,0
7414,50,43824,1,1,18,96,1,42,12,3,32,186,4,3,1,4,8,20,0
3076,46,66653,1,1,18,452,18,102,16,18,6,612,4,4,2,12,3,25,0
6355,43,44359,1,1,19,20,0,14,7,3,1,45,3,2,0,4,3,12,0
7959,60,79410,0,0,19,658,80,483,123,13,13,1370,1,3,2,5,1,12,0
5512,44,55842,0,1,19,451,0,39,0,4,24,518,1,7,1,8,5,22,0
10102,55,79946,0,0,19,395,183,565,166,141,28,1478,1,5,11,5,3,25,0
9369,42,88194,0,1,19,688,14,309,201,24,38,1274,1,11,10,10,5,37,1
3711,77,80184,0,0,19,1035,134,670,25,38,0,1902,1,6,3,10,3,23,1
6931,54,76982,0,0,19,464,151,292,65,60,30,1062,1,8,3,4,4,20,1
9596,41,65295,0,0,19,365,32,117,34,110,6,664,1,3,3,13,2,22,0
2727,48,57100,0,0,19,181,21,69,39,3,96,409,1,3,3,6,3,16,0
8416,40,29009,1,0,19,6,6,15,10,5,2,44,2,2,0,3,6,13,0
3967,50,78931,0,0,19,331,197,170,58,152,35,943,1,2,8,13,1,25,0
2139,46,7500,1,0,19,3,1,10,3,2,12,31,3,2,0,3,5,13,0
2162,45,56939,0,1,19,256,34,103,90,29,49,561,2,3,3,10,3,21,0
9242,31,64509,0,0,19,836,185,575,24,25,77,1722,1,6,3,9,4,23,1
10595,31,30093,0,0,19,2,6,28,13,4,16,69,1,2,0,3,7,13,0
4855,47,30351,1,0,19,14,0,24,3,3,2,46,1,3,0,2,9,15,0
5049,47,30351,1,0,19,14,0,24,3,3,2,46,1,3,0,2,9,15,0
4967,61,38201,0,1,19,233,0,23,0,0,12,268,4,5,1,5,8,23,0
9215,41,43974,1,0,19,378,0,101,0,0,72,551,5,6,4,6,7,28,0
3525,51,38200,1,1,19,12,0,4,0,0,1,17,1,1,0,2,7,11,0
3619,61,87305,0,0,19,345,25,501,63,138,80,1152,1,5,3,8,2,19,1
4415,60,16860,1,1,19,10,4,4,3,3,14,38,3,1,1,3,7,15,0
3645,49,27213,1,0,19,19,3,26,10,9,3,70,3,2,0,4,8,17,0
4692,45,7500,1,0,19,7,0,12,13,7,32,71,5,4,1,2,9,21,1
3955,56,4861,0,0,20,2,1,1,1,0,1,6,0,0,0,0,14,14,0
5313,50,38196,1,1,20,30,0,11,0,0,3,44,3,2,0,4,5,14,0
7196,71,41145,1,1,20,9,0,3,0,0,1,13,1,0,0,3,3,7,0
1381,39,38513,1,0,20,172,3,115,16,0,18,324,5,6,1,5,8,25,0
10951,53,45688,0,1,20,279,0,18,0,0,9,306,2,3,1,8,4,18,1
4322,63,77863,0,0,20,881,38,319,16,25,12,1291,1,4,5,10,2,22,0
7444,52,42169,1,1,20,19,0,9,0,0,2,30,2,1,0,3,8,14,0
2942,57,45906,0,1,20,305,3,27,4,3,144,486,2,5,4,4,5,20,1
2874,33,35388,1,0,20,6,4,7,4,3,8,32,1,1,0,3,7,12,0
3667,52,80952,0,0,20,778,178,689,41,27,44,1757,1,8,5,11,8,33,1
3697,67,39898,0,1,20,69,8,26,12,7,12,134,2,3,0,4,7,16,0
9955,67,39898,0,1,20,69,8,26,12,7,12,134,2,3,0,4,7,16,0
5320,48,44051,1,1,20,79,7,58,6,3,18,171,4,3,1,4,6,18,0
6422,67,86718,0,0,20,344,189,482,50,33,172,1270,1,5,6,5,2,19,0
3690,35,80141,0,0,20,1184,102,673,52,40,40,2091,1,7,4,10,6,28,1
2408,45,58597,1,1,20,490,0,184,10,28,21,733,12,7,4,9,7,39,0
9260,76,70356,0,0,20,1349,16,249,43,16,33,1706,2,10,6,9,6,33,0
9648,54,46904,1,1,20,153,4,56,0,9,31,253,4,5,1,4,8,22,0
4939,75,37760,0,0,20,84,5,38,150,12,28,317,2,4,1,6,7,20,0
8652,75,37760,0,0,20,84,5,38,150,12,28,317,2,4,1,6,7,20,0
4702,57,61839,0,0,20,1000,155,379,224,17,120,1895,1,4,8,4,8,25,0
2587,49,29791,1,0,21,14,0,6,0,0,0,20,2,2,0,3,5,12,0
2811,58,48918,1,1,21,52,0,9,0,0,1,62,2,1,0,4,4,11,0
9150,58,48918,1,1,21,52,0,9,0,0,1,62,2,1,0,4,4,11,0
10127,56,58692,0,1,21,301,11,61,4,7,11,395,1,8,2,4,7,22,0
5493,45,39356,1,1,21,15,0,2,0,0,6,23,1,1,0,2,6,10,1
2666,49,76234,0,1,21,519,50,167,130,0,41,907,1,8,3,11,3,26,1
10099,37,55434,1,0,21,238,115,215,169,69,76,882,3,5,3,13,4,28,0
10562,75,66835,0,0,21,620,26,195,34,17,141,1033,1,6,4,13,2,26,0
7881,75,66835,0,0,21,620,26,195,34,17,141,1033,1,6,4,13,2,26,0
6721,70,71965,0,1,21,572,19,286,50,38,248,1213,3,6,3,5,3,20,0
5204,50,74538,0,0,21,380,98,733,110,112,28,1461,1,8,8,5,3,25,1
5209,67,50002,0,1,21,443,5,71,21,16,82,638,2,8,2,7,7,26,0
10128,63,53977,0,1,21,620,16,165,0,24,82,907,5,5,5,12,5,32,0
9284,63,53977,0,1,21,620,16,165,0,24,82,907,5,5,5,12,5,32,0
8643,50,69930,0,0,21,252,98,827,219,70,196,1662,1,4,5,12,3,25,0
1685,54,62981,0,0,21,796,14,590,38,44,0,1482,1,4,5,13,3,26,1
2877,47,46014,1,1,21,410,0,59,19,9,44,541,10,7,1,8,7,33,0
8369,34,18227,1,0,21,1,2,7,4,3,11,28,1,0,1,2,8,12,0
6233,45,65991,0,1,21,507,19,364,25,47,9,971,3,9,5,10,7,34,0
195,49,38808,1,0,21,125,17,52,3,19,30,246,4,5,1,4,8,22,1
1501,39,160803,0,0,21,55,16,1622,17,3,4,1717,15,0,28,1,0,44,0
10846,43,43783,1,0,22,327,9,125,25,4,139,629,6,7,1,8,7,29,1
8341,52,30396,1,0,22,15,0,6,0,1,12,34,2,1,1,2,7,13,1
10766,57,65526,0,1,22,397,19,69,12,0,9,506,1,4,4,8,2,19,0
9971,57,65526,0,1,22,397,19,69,12,0,9,506,1,4,4,8,2,19,0
1740,77,55956,0,0,22,760,38,104,50,9,38,999,2,7,3,4,4,20,1
8737,43,55563,0,1,22,29,1,9,2,0,2,43,1,2,0,3,3,9,0
6466,56,57236,1,1,22,105,0,9,2,1,4,121,3,2,1,4,3,13,0
10430,48,89694,1,1,22,1126,28,211,37,28,42,1472,3,4,3,4,5,19,1
8773,50,57420,0,1,22,280,0,18,0,0,24,322,3,5,1,6,7,22,1
2371,49,33622,1,1,22,39,1,22,3,4,12,81,3,2,0,4,7,16,0
7786,35,29999,1,0,22,68,7,59,10,5,11,160,4,3,1,4,8,20,0
4088,59,31497,0,1,22,108,1,28,13,1,4,155,2,3,1,4,8,18,0
4971,59,31497,0,1,22,108,1,28,13,1,4,155,2,3,1,4,8,18,0
10560,41,36802,1,0,23,16,1,2,0,0,1,20,1,1,0,3,5,10,0
6892,53,61671,0,1,23,641,7,56,0,0,28,732,8,10,4,6,8,36,1
11004,128,60182,0,1,23,8,0,5,7,0,2,22,1,1,0,2,4,8,0
1818,50,29732,1,0,23,25,0,8,0,1,4,38,1,2,0,2,9,14,0
9485,35,45921,0,0,23,102,9,49,24,3,12,199,1,2,1,6,4,14,0
6646,37,16529,1,0,23,3,0,5,13,0,1,22,1,1,0,3,6,11,0
4248,61,98777,0,0,23,1000,19,711,125,115,38,2008,0,4,6,9,1,20,1
7451,61,98777,0,0,23,1000,19,711,125,115,38,2008,0,4,6,9,1,20,1
7861,69,77027,0,1,23,820,57,242,45,0,11,1175,2,8,3,6,4,23,0
5232,56,69139,0,1,23,86,12,75,33,15,6,227,1,4,1,5,4,15,0
3011,56,69139,0,1,23,86,12,75,33,15,6,227,1,4,1,5,4,15,0
5758,39,65169,0,0,23,1074,0,69,0,0,46,1189,1,10,4,13,6,34,1
2173,69,40049,0,1,23,13,6,7,0,3,3,32,1,1,0,3,6,11,0
10711,76,69755,0,0,23,217,77,373,111,23,93,894,1,3,6,12,1,23,0
2782,60,54456,0,1,23,352,0,27,10,0,15,404,3,6,1,7,6,23,0
9432,44,666666,1,0,23,9,14,18,8,1,12,62,4,3,1,3,6,17,0
5872,70,60689,0,1,23,240,90,216,63,6,24,639,4,4,4,10,3,25,0
11187,43,26487,1,0,23,2,8,10,12,14,23,69,3,2,1,3,5,14,0
2428,51,28164,1,0,23,3,18,26,11,8,12,78,3,2,0,4,7,16,0
1726,51,22585,0,0,23,3,9,15,13,2,39,81,1,1,1,2,9,14,1
1802,50,64795,0,1,23,412,5,119,38,29,77,680,3,3,3,12,2,23,0
1162,34,42000,0,0,23,124,83,267,85,59,35,653,2,5,2,11,5,25,0
10643,34,42000,0,0,23,124,83,267,85,59,35,653,2,5,2,11,5,25,0
11112,55,70713,0,1,23,736,114,279,82,76,190,1477,6,5,6,8,3,28,0
2114,75,82800,0,0,23,1006,22,115,59,68,45,1315,1,7,6,12,3,29,1
4261,75,82800,0,0,23,1006,22,115,59,68,45,1315,1,7,6,12,3,29,1
2457,46,30801,0,1,23,8,4,5,15,2,11,45,2,1,0,3,7,13,0
2495,47,83891,0,1,24,217,38,350,111,85,15,816,1,4,7,10,1,23,0
6983,71,38054,1,1,24,23,2,17,2,1,0,45,2,2,0,3,7,14,0
3436,52,14045,1,0,24,11,0,5,2,1,1,20,1,1,0,3,7,12,0
7505,64,44155,1,1,24,22,1,9,0,0,14,46,1,1,1,2,4,9,0
4286,51,57642,0,1,24,580,6,58,8,0,27,679,3,7,6,6,4,26,1
7224,44,31353,1,1,24,10,0,10,3,1,7,31,2,1,1,2,8,14,0
6215,44,31353,1,1,24,10,0,10,3,1,7,31,2,1,1,2,8,14,0
968,53,41335,1,0,24,112,19,21,16,14,5,187,3,4,1,4,7,19,0
4096,53,41335,1,0,24,112,19,21,16,14,5,187,3,4,1,4,7,19,0
3153,64,40737,2,1,24,11,0,4,0,0,2,17,1,1,0,2,8,12,0
6504,46,19789,1,0,24,2,5,9,28,6,28,78,3,2,1,3,5,14,1
5329,72,35946,1,1,24,8,0,3,0,0,0,11,1,0,0,3,5,9,0
1175,38,36262,0,0,24,88,39,54,64,28,153,426,1,3,5,3,6,18,1
1377,67,44551,0,1,24,182,4,33,0,0,66,285,2,4,1,5,7,19,0
4607,62,71367,0,0,24,227,23,389,42,21,75,777,1,4,5,7,2,19,0
4944,62,71367,0,0,24,227,23,389,42,21,75,777,1,4,5,7,2,19,0
9483,62,57957,0,1,24,290,59,177,77,5,29,637,7,4,6,8,3,28,0
1378,49,50334,0,1,24,284,16,160,84,16,134,694,6,7,4,6,6,29,0
5991,72,48150,0,1,24,173,2,39,3,2,47,266,3,5,1,4,7,20,0
2807,52,56796,0,1,24,656,38,161,62,47,37,1001,3,8,9,7,7,34,0
1052,52,56796,0,1,24,656,38,161,62,47,37,1001,3,8,9,7,7,34,0
9760,58,52278,0,1,24,953,0,71,0,0,174,1198,6,10,5,10,8,39,0
7101,58,52278,0,1,24,953,0,71,0,0,174,1198,6,10,5,10,8,39,0
9909,25,7500,0,0,24,3,18,14,15,22,50,122,3,3,1,3,9,19,0
5907,69,33444,1,1,24,8,0,8,0,0,2,18,1,1,0,2,8,12,0
793,48,20895,1,0,24,18,3,17,3,0,4,45,1,2,0,3,9,15,0
8832,45,37509,1,0,24,37,5,56,12,8,5,123,2,3,0,4,7,16,0
2535,43,88097,1,0,24,163,0,480,0,126,75,844,1,6,5,8,9,29,1
1523,48,59041,1,1,25,69,2,15,2,2,6,96,2,2,0,4,5,13,0
1839,47,43322,0,0,25,56,7,48,10,2,18,141,1,3,0,4,7,15,0
9972,66,46015,1,1,25,38,0,2,0,0,6,46,1,1,0,3,7,12,1
2945,66,46015,1,1,25,38,0,2,0,0,6,46,1,1,0,3,7,12,1
9291,62,34242,0,1,25,8,2,4,0,0,1,15,1,0,0,3,5,9,0
2829,66,65210,0,1,25,626,0,70,0,7,28,731,2,9,3,8,6,28,1
8594,63,50520,0,1,25,112,0,6,2,1,14,135,2,3,1,3,6,15,0
1592,51,90765,0,0,25,547,99,812,151,82,33,1724,0,4,6,5,1,16,1
4310,77,80589,0,0,25,507,93,520,242,40,26,1428,1,5,10,5,1,22,1
6950,63,49572,1,1,25,35,1,16,0,1,1,54,2,2,0,3,7,14,0
8492,43,75437,0,0,25,795,0,545,95,58,0,1493,1,8,4,10,6,29,1
5684,50,44635,1,1,25,56,0,9,0,0,3,68,2,2,0,3,7,14,0
5909,57,58512,0,1,25,895,10,101,13,0,152,1171,5,3,4,8,8,28,0
9855,69,62000,0,1,25,899,0,101,0,0,20,1020,1,6,6,13,4,30,1
975,65,54252,1,1,25,178,4,26,8,4,44,264,5,4,1,5,6,21,0
8754,47,45068,0,1,25,14,0,3,0,0,3,20,1,1,0,2,7,11,0
1456,42,60474,0,1,25,265,199,303,234,9,170,1180,7,10,2,12,7,38,0
2849,42,60474,0,1,25,265,199,303,234,9,170,1180,7,10,2,12,7,38,0
9984,40,56337,1,1,25,349,16,144,28,5,182,724,5,8,5,4,8,30,1
5527,34,22434,1,0,25,4,12,11,3,13,15,58,2,2,0,3,8,15,0
5628,39,61416,0,0,25,848,154,323,201,61,78,1665,1,10,3,10,6,30,1
7627,46,92163,0,0,25,817,183,797,106,163,20,2086,0,5,11,5,2,23,1
1351,65,58656,0,1,25,962,12,194,16,24,12,1220,4,7,8,13,6,38,1
10395,35,8940,1,0,25,1,45,3,4,6,42,101,3,3,1,3,8,18,0
6961,47,26751,2,0,26,1,1,5,0,3,1,11,1,1,0,2,8,12,0
10196,43,71427,2,0,26,212,123,177,15,64,23,614,2,8,2,8,4,24,0
6182,37,26646,1,0,26,11,4,20,10,3,5,53,2,2,0,4,6,14,0
10432,47,19346,1,0,26,2,0,9,3,6,2,22,1,1,0,3,8,13,0
1542,46,56243,1,2,26,347,0,35,4,3,7,396,6,4,2,8,5,25,0
4220,51,59892,0,1,26,73,0,13,0,1,0,87,1,2,1,3,3,10,0
4141,56,71613,0,0,26,426,49,127,111,21,42,776,1,8,2,10,4,25,0
1940,35,25252,1,0,26,1,3,4,2,2,6,18,1,1,0,2,8,12,0
1506,46,42160,1,1,26,48,9,45,3,15,20,140,4,2,1,4,6,17,0
6347,42,15862,1,0,26,1,1,4,11,9,10,36,1,1,0,3,8,13,0
1361,47,82584,0,0,26,1076,68,103,29,91,68,1435,1,3,4,8,1,17,1
9422,32,38360,1,0,26,36,2,42,20,21,10,131,2,2,1,4,3,12,0
1081,64,75283,1,2,26,733,9,180,12,19,66,1019,11,6,3,5,4,29,0
7458,65,34941,1,1,26,39,2,25,4,3,24,97,2,3,0,3,8,16,0
1012,69,61823,0,1,26,523,7,134,37,14,169,884,4,8,2,10,7,31,0
5453,65,90226,0,0,26,1083,108,649,253,151,108,2352,1,4,7,12,2,26,1
6818,47,44989,0,1,26,98,0,106,49,10,106,369,5,5,1,5,6,22,0
7807,47,44989,0,1,26,98,0,106,49,10,106,369,5,5,1,5,6,22,0
7532,41,43586,0,1,26,99,2,11,4,0,16,132,3,3,0,4,8,18,0
8346,47,32233,1,0,26,138,15,35,25,11,72,296,2,6,2,2,9,21,1
5564,52,62882,0,1,26,509,133,497,78,24,97,1338,2,7,5,6,4,24,0
3267,58,57288,0,1,27,527,0,21,0,0,60,608,3,8,1,8,6,26,1
3091,40,75774,1,0,27,340,21,134,258,14,56,823,1,7,5,8,4,25,0
762,40,75774,1,0,27,340,21,134,258,14,56,823,1,7,5,8,4,25,0
8029,33,90247,0,0,27,1184,32,352,21,16,16,1621,1,3,4,7,1,16,1
4376,61,32218,0,0,27,10,24,15,13,1,30,93,1,2,1,3,7,14,1
10981,33,84219,0,0,27,434,137,400,45,137,45,1198,1,3,4,10,1,19,0
486,33,84219,0,0,27,434,137,400,45,137,45,1198,1,3,4,10,1,19,0
1158,55,48877,0,1,27,102,1,15,2,0,24,144,1,3,0,4,7,15,0
9119,71,60905,0,1,27,208,17,76,36,17,38,392,2,3,3,7,2,17,0
6694,57,75236,0,1,27,438,66,400,12,38,114,1068,1,8,3,13,4,29,0
10573,68,62551,0,0,27,125,16,98,134,21,27,421,1,6,7,4,3,21,1
10140,38,70123,0,0,27,1308,0,396,23,0,0,1727,1,5,7,4,3,20,1
2286,59,50785,1,1,27,64,1,21,0,1,27,114,2,2,1,3,6,14,0
8420,51,15315,0,0,27,7,4,13,15,8,17,64,2,2,0,4,5,13,0
10065,51,15315,0,0,27,7,4,13,15,8,17,64,2,2,0,4,5,13,0
1029,51,64413,0,1,27,200,5,44,0,10,20,279,1,5,1,5,5,17,0
4207,40,87171,0,0,27,1001,44,107,58,44,44,1298,1,6,7,11,2,27,1
10277,60,30081,0,1,27,36,0,2,0,0,4,42,1,1,0,3,7,12,0
4436,45,20180,0,0,27,18,42,24,15,20,18,137,1,2,1,4,7,15,0
2929,45,20180,0,0,27,18,42,24,15,20,18,137,1,2,1,4,7,15,0
6281,55,55686,0,1,27,673,0,199,37,47,26,982,2,6,3,5,4,20,1
10390,62,26887,0,1,27,6,7,4,3,4,6,30,1,1,0,3,6,11,0
2574,44,61996,0,1,27,1050,12,144,0,0,24,1230,3,6,4,8,5,26,1
709,69,51537,0,1,27,787,20,204,0,0,92,1103,3,2,2,11,8,26,0
5955,59,72025,0,0,27,833,33,549,151,133,233,1932,1,4,3,8,3,19,0
8486,50,30538,1,0,27,284,0,52,8,3,20,367,4,9,0,4,10,27,0
10343,30,61618,0,0,27,605,91,399,0,45,205,1345,2,3,6,8,3,22,0
6652,56,77343,0,0,28,227,151,573,98,54,31,1134,1,3,4,9,1,18,0
8746,32,75433,1,0,28,800,0,297,0,34,57,1188,2,2,5,10,6,25,1
4686,59,82571,0,0,28,861,31,558,62,95,79,1686,0,6,5,13,2,26,1
3551,67,60033,0,1,28,62,1,57,19,11,48,198,2,2,1,5,2,12,0
4338,38,39062,1,0,28,23,0,9,0,0,12,44,1,1,0,3,4,9,1
4444,49,30023,1,0,28,11,0,16,7,6,21,61,1,2,0,3,8,14,0
498,51,30015,1,0,28,25,0,22,2,3,5,57,2,1,0,4,5,12,0
8230,41,33228,1,0,28,22,2,31,7,4,5,71,1,2,0,3,7,13,0
2826,54,22574,2,1,28,25,0,8,2,0,2,37,2,2,0,3,7,14,0
6222,54,22574,2,1,28,25,0,8,2,0,2,37,2,2,0,3,7,14,0
7352,64,55267,0,1,28,161,28,136,32,3,45,405,4,3,4,6,3,20,0
10928,63,66886,0,1,28,315,4,62,41,31,146,599,2,7,1,7,5,22,0
10736,50,72258,0,1,28,522,0,522,227,120,134,1525,2,6,9,5,2,24,0
10163,37,82733,0,0,28,712,50,420,65,38,38,1323,1,8,4,7,4,24,0
6168,58,45146,1,1,28,33,0,5,0,0,15,53,2,1,1,2,4,10,0
4656,31,51250,1,0,28,342,32,230,34,32,40,710,5,10,5,4,9,33,1
626,70,32871,1,1,28,22,2,12,0,2,5,43,1,1,0,3,4,9,0
3870,43,63855,0,0,28,359,35,314,93,116,89,1006,1,7,3,13,4,28,0
6299,53,42564,0,1,28,324,48,186,39,18,198,813,6,6,8,4,7,31,1
7798,49,46344,0,1,28,233,20,57,8,20,91,429,4,7,1,5,7,24,0
9973,58,50437,0,2,28,370,9,92,6,9,4,490,3,7,1,8,7,26,0
4299,61,70971,0,1,28,1001,17,572,93,125,17,1825,7,11,11,5,7,41,0
10971,44,37774,2,0,28,173,8,107,7,2,176,473,4,7,2,3,9,25,1
9931,58,4023,1,1,29,5,0,1,1,1,1,9,15,0,0,0,19,34,0
6679,55,33279,0,0,29,10,3,3,0,0,0,16,1,0,0,3,3,7,0
5961,43,42693,1,0,29,8,4,20,6,3,16,57,1,1,0,3,5,10,0
6255,69,70545,0,1,29,138,39,63,55,18,21,334,1,4,1,7,2,15,0
8614,64,65486,0,1,29,245,19,125,37,67,14,507,1,4,2,10,2,19,0
7828,40,77882,0,0,29,68,129,396,188,22,15,818,1,3,3,5,1,13,0
1277,61,78468,0,0,29,434,22,388,104,22,34,1004,1,10,7,10,4,32,1
3595,58,77226,0,1,29,631,43,239,128,76,21,1138,2,6,8,12,3,31,0
5735,30,90638,0,0,29,1156,120,915,94,144,96,2525,1,3,4,10,1,19,1
5350,30,90638,0,0,29,1156,120,915,94,144,96,2525,1,3,4,10,1,19,1
4137,73,70666,0,0,29,398,40,367,119,122,30,1076,1,7,4,4,4,20,0
6357,62,59052,0,1,29,230,35,75,63,57,31,491,3,7,1,7,5,23,0
9316,69,13084,0,0,29,2,0,7,3,7,10,29,1,1,0,3,6,11,0
3578,72,49160,0,1,29,122,21,43,25,10,15,236,2,3,1,6,6,18,0
153,68,23272,0,0,29,19,3,6,4,2,12,46,1,1,0,3,4,9,0
10524,58,49476,0,1,29,386,23,95,54,41,196,795,4,2,11,5,2,24,0
1518,56,62694,1,1,29,379,6,157,25,91,91,749,5,9,3,7,7,31,0
2036,48,57906,0,1,29,243,11,119,10,3,15,401,3,4,2,8,4,21,0
9495,39,71853,0,0,29,358,108,413,141,97,32,1149,1,2,8,6,1,18,0
2631,39,71853,0,0,29,358,108,413,141,97,32,1149,1,2,8,6,1,18,0
6312,62,65031,0,1,29,258,107,291,84,37,86,863,4,10,3,13,7,37,0
615,61,30507,0,0,29,65,36,74,38,20,110,343,1,5,1,4,7,18,0
4406,51,67419,0,1,29,846,84,352,91,56,42,1471,4,9,4,8,5,30,0
10061,71,59462,0,1,29,724,17,143,0,8,196,1088,2,9,2,12,7,32,0
10619,27,95529,0,0,29,770,29,890,250,27,24,1990,1,7,3,7,3,21,1
4945,68,53653,0,0,29,815,10,239,28,10,108,1210,2,10,4,12,6,34,0
1777,41,25965,0,0,29,2,2,11,41,7,11,74,1,2,0,3,8,14,0
4023,51,22979,1,0,29,16,17,19,20,21,22,115,3,3,2,2,8,18,0
7922,70,64950,0,1,29,819,0,72,12,0,63,966,2,11,2,10,7,32,1
10699,36,44322,1,0,30,46,0,40,3,0,3,92,2,3,0,3,8,16,0
7516,38,30096,1,0,30,5,3,11,12,5,9,45,1,2,0,3,6,12,0
3129,38,30096,1,0,30,5,3,11,12,5,9,45,1,2,0,3,6,12,0
5121,44,56628,0,1,30,479,5,82,7,17,171,761,2,7,6,5,5,25,1
2186,44,82326,0,0,30,938,142,754,159,81,183,2257,1,5,10,6,2,24,1
10548,26,71163,0,0,30,283,17,372,138,106,44,960,1,3,8,12,1,25,0
6384,43,71022,0,1,30,909,12,278,0,12,242,1453,3,5,2,11,8,29,1
2625,67,42607,0,1,30,156,29,56,30,32,47,350,2,3,2,7,3,17,0
1676,46,43057,0,1,30,213,2,44,0,2,5,266,4,4,2,5,5,20,0
5534,46,47808,0,1,30,123,1,26,2,0,72,224,2,3,2,3,7,17,1
6859,34,29236,1,0,30,37,4,24,16,9,9,99,2,4,0,3,9,18,0
271,52,40590,1,1,30,154,0,50,6,11,37,258,5,3,4,3,6,21,1
7699,52,40590,1,1,30,154,0,50,6,11,37,258,5,3,4,3,6,21,1
7832,62,77520,0,1,30,940,44,396,0,88,58,1526,1,8,7,7,4,27,1
938,40,40211,1,1,30,51,1,7,2,1,25,87,2,2,1,2,8,15,1
7873,48,63516,1,1,30,141,11,114,15,14,5,300,4,4,1,7,5,21,0
9967,47,53034,1,1,30,160,15,196,15,11,50,447,8,6,1,7,8,30,0
1087,46,22669,1,0,30,16,14,36,37,22,48,173,3,4,1,2,9,19,0
8314,39,79908,0,0,30,557,129,761,29,185,111,1772,1,5,6,7,2,21,1
3762,35,69867,0,0,30,196,0,512,33,130,54,925,1,3,5,8,1,18,1
10383,55,70287,0,0,30,295,35,482,121,120,40,1093,1,5,5,10,3,24,0
6798,55,37070,1,1,30,231,7,137,4,15,39,433,9,5,1,8,7,30,0
4168,55,37070,1,1,30,231,7,137,4,15,39,433,9,5,1,8,7,30,0
6690,55,38179,1,1,30,38,4,22,4,2,20,90,4,3,1,3,7,18,0
10602,38,39922,1,0,30,29,12,59,19,1,36,156,2,3,0,4,8,17,0
3220,38,39922,1,0,30,29,12,59,19,1,36,156,2,3,0,4,8,17,0
5424,38,39922,1,0,30,29,12,59,19,1,36,156,2,3,0,4,8,17,0
7488,58,64191,0,1,30,420,15,186,151,38,15,825,3,5,3,13,3,27,0
5289,46,41658,1,1,30,8,4,12,15,4,29,72,2,1,1,2,4,10,0
347,45,40780,0,1,30,229,27,71,13,3,34,377,4,7,1,5,9,26,0
5236,42,77568,0,1,30,1230,0,396,232,178,158,2194,1,10,2,8,5,26,1
9478,36,66503,1,0,30,91,64,128,65,3,50,401,2,4,3,6,3,18,0
477,35,83512,0,0,31,1060,61,835,80,20,101,2157,1,4,7,10,1,23,1
7411,57,31686,1,1,31,11,0,5,0,0,1,17,2,1,0,3,6,12,0
3107,45,71322,0,1,31,121,24,124,24,15,42,350,1,4,1,7,2,15,0
7437,33,27938,1,0,31,13,0,8,2,1,5,29,1,1,0,4,3,9,0
255,70,22263,1,1,31,17,0,2,0,0,2,21,2,1,0,3,6,12,0
3790,65,34633,2,1,31,8,1,5,0,0,1,15,1,1,0,2,6,10,0
749,40,42162,1,0,31,46,7,59,2,4,27,145,2,3,1,3,6,15,1
1503,45,162397,1,1,31,85,1,16,2,1,2,107,0,0,0,1,1,2,0
8650,43,54162,1,1,31,5,6,10,6,5,10,42,1,1,0,3,4,9,0
607,66,41769,0,1,31,302,29,131,32,0,27,521,6,8,1,7,8,30,0
1008,40,44953,0,0,31,728,17,133,11,8,124,1021,1,7,3,13,6,30,1
9396,43,37717,1,0,31,9,0,6,4,1,5,25,1,1,0,2,9,13,0
933,43,37717,1,0,31,9,0,6,4,1,5,25,1,1,0,2,9,13,0
5710,51,40548,0,1,31,110,0,5,2,0,3,120,2,2,1,4,5,14,1
2882,46,67893,0,1,31,711,28,142,49,18,47,995,2,3,2,9,8,24,0
2379,68,69267,0,0,31,778,44,499,95,73,146,1635,2,3,4,5,7,21,0
5342,45,9548,1,0,31,0,1,3,10,6,9,29,2,1,0,3,8,14,0
3262,63,68281,0,0,31,995,112,417,42,48,41,1655,1,2,9,13,5,30,0
5832,61,92556,0,0,32,493,183,352,184,23,28,1263,0,3,5,13,0,21,0
5025,42,48526,1,0,32,23,17,23,43,20,9,135,1,2,1,4,3,11,0
569,30,90273,0,0,32,704,129,853,120,74,111,1991,1,5,6,7,2,21,1
3102,40,19414,1,0,32,2,3,12,3,5,7,32,1,1,0,3,8,13,0
9449,63,79761,0,1,32,415,5,124,15,35,11,605,1,5,2,11,3,22,0
8104,70,53312,0,0,32,241,0,12,0,0,25,278,1,5,1,5,7,19,0
75,39,41039,0,0,32,34,11,137,179,61,45,467,1,8,1,5,8,23,0
6421,60,88347,0,0,32,1050,178,555,77,138,118,2116,1,4,7,9,1,22,1
3037,38,50150,0,0,32,135,46,92,65,61,11,410,2,5,2,7,5,21,0
4698,38,50150,0,0,32,135,46,92,65,61,11,410,2,5,2,7,5,21,0
948,50,10245,1,0,32,4,7,7,6,4,13,41,3,1,2,2,5,13,0
6177,36,33454,1,0,32,76,10,56,3,1,23,169,2,4,0,4,8,18,0
3517,69,40887,1,1,32,50,4,44,10,10,43,161,3,3,1,3,9,19,0
3491,46,55914,0,1,32,384,60,364,119,101,232,1260,4,11,6,8,7,36,0
7610,38,37292,1,0,32,275,0,86,10,23,66,460,5,6,3,5,8,27,0
4377,50,52914,0,1,32,254,10,44,30,10,227,575,2,7,3,3,7,22,1
9850,49,24884,1,0,32,3,6,7,0,0,3,19,1,0,0,3,7,11,0
5544,51,67384,0,1,32,957,40,175,158,53,107,1490,2,7,8,5,5,27,1
6497,61,51651,0,1,32,293,6,23,13,6,92,433,4,6,2,5,8,25,0
4543,41,82497,0,0,32,777,129,573,216,21,203,1919,1,2,7,9,4,23,1
5117,58,32632,0,0,32,63,151,137,153,19,53,576,2,4,4,8,5,23,0
1448,58,33562,1,2,33,21,12,12,0,3,3,51,3,2,0,4,4,13,0
6887,54,79146,1,1,33,245,16,223,21,43,16,564,2,8,1,8,6,25,0
7500,54,79146,1,1,33,245,16,223,21,43,16,564,2,8,1,8,6,25,0
2724,40,36143,1,0,33,12,0,1,0,0,6,19,1,0,1,2,3,7,0
2256,48,27159,1,1,33,17,0,3,0,0,1,21,2,1,0,3,6,12,0
1100,61,41275,1,2,33,24,4,22,0,2,9,61,4,3,1,3,5,16,0
7725,56,76800,0,0,33,173,26,255,35,71,81,641,1,4,4,7,1,17,0
2612,34,75794,0,0,33,754,160,625,63,32,48,1682,1,7,5,12,3,28,1
113,70,30833,1,1,33,11,0,7,3,1,6,28,2,1,0,3,5,11,0
2868,72,26518,1,1,33,20,1,28,3,3,2,57,3,2,0,3,8,16,0
4216,40,91065,0,0,33,822,114,108,179,137,114,1474,1,7,9,9,3,29,1
199,59,45183,0,0,33,219,3,60,12,9,12,315,1,4,1,7,7,20,1
359,71,48070,0,1,33,373,14,83,6,9,19,504,3,8,2,6,7,26,0
8842,50,30372,1,1,33,15,0,12,7,3,7,44,3,2,0,3,7,15,0
2154,50,30372,1,1,33,15,0,12,7,3,7,44,3,2,0,3,7,15,0
6050,46,57036,0,1,33,1171,43,219,19,14,47,1513,4,6,3,13,9,35,1
9204,51,66731,0,1,33,371,159,194,58,106,141,1029,4,4,3,6,3,20,0
4472,51,35682,1,0,34,23,0,8,6,2,18,57,1,1,1,3,2,8,0
6864,32,10979,0,0,34,8,4,10,2,2,4,30,2,3,0,3,5,13,0
10617,32,10979,0,0,34,8,4,10,2,2,4,30,2,3,0,3,5,13,0
3924,56,57912,0,1,34,801,0,80,0,0,35,916,5,8,3,12,5,33,1
5654,49,36026,2,1,34,20,4,10,6,4,17,61,2,2,0,3,6,13,0
9216,50,35788,1,1,34,23,2,11,3,1,4,44,2,2,0,3,6,13,0
8086,62,42243,1,1,34,48,0,2,0,0,5,55,2,2,0,3,7,14,0
9097,65,46086,0,1,34,244,8,32,7,2,50,343,4,3,1,8,4,20,0
7631,43,61346,1,0,34,562,58,168,43,16,142,989,1,5,7,10,3,26,0
7275,50,33316,1,1,34,79,1,31,4,4,12,131,3,2,1,4,6,16,0
8334,50,33316,1,1,34,79,1,31,4,4,12,131,3,2,1,4,6,16,0
1987,34,21063,1,0,34,1,10,11,19,3,15,59,2,2,0,3,6,13,0
2281,51,33697,1,0,34,4,3,7,0,3,11,28,1,1,0,2,7,11,1
7034,43,25804,1,0,34,8,7,9,13,6,12,55,2,2,0,3,8,15,0
2797,44,72117,0,1,34,707,20,171,65,60,50,1073,1,9,7,9,5,31,0
3934,55,61286,0,1,34,356,0,107,19,9,117,608,2,7,1,8,5,23,0
2493,55,61286,0,1,34,356,0,107,19,9,117,608,2,7,1,8,5,23,0
3759,63,65196,0,2,34,743,19,181,12,0,200,1155,2,7,6,11,5,31,1
965,50,55635,0,1,34,235,65,164,50,49,27,590,4,7,3,7,6,27,0
7378,40,42021,1,0,34,393,5,136,7,5,27,573,5,10,1,6,9,31,1
1859,49,75251,0,0,34,721,111,925,97,18,18,1890,1,7,6,5,5,24,0
6263,53,35322,1,2,34,28,9,37,12,7,13,106,3,2,0,4,8,17,0
2072,52,53374,0,1,34,896,10,101,13,10,34,1064,6,4,2,9,9,30,1
8908,62,87195,0,0,35,217,76,690,50,26,38,1097,1,3,11,5,1,21,0
738,40,42395,1,1,35,48,13,57,24,15,25,182,4,3,1,4,7,19,0
10129,55,82427,0,0,35,482,147,509,104,107,107,1456,1,3,5,12,1,22,1
807,52,44602,1,1,35,167,2,89,0,0,34,292,6,6,1,4,8,25,0
3334,70,94642,0,0,35,879,143,797,106,143,143,2211,0,5,7,9,1,22,1
5423,38,28359,1,0,35,6,0,5,2,1,2,16,1,1,0,2,7,11,0
4426,46,55801,1,1,35,367,4,51,6,4,95,527,6,7,2,6,7,28,1
10489,48,92955,0,0,35,693,21,925,31,24,84,1778,1,6,7,9,2,25,1
2570,53,56534,0,1,35,691,7,61,10,0,46,815,4,10,4,7,8,33,1
3834,59,69627,0,1,35,231,161,215,171,30,53,861,2,8,2,11,5,28,0
590,51,78579,0,0,35,816,66,549,216,66,99,1812,1,5,6,4,3,19,0
4791,41,44964,1,1,35,19,1,17,2,0,2,41,1,1,0,3,8,13,0
5304,47,30899,1,0,35,24,0,8,0,0,1,33,2,1,0,3,6,12,0
2426,57,78825,0,0,35,483,74,114,169,37,18,895,1,5,10,13,3,32,0
35,34,25545,1,0,35,32,1,64,16,12,85,210,3,2,2,3,6,16,0
8041,50,47111,0,1,35,595,71,153,120,112,41,1092,6,3,2,10,9,30,0
3584,66,49667,0,0,35,1181,26,120,17,13,39,1396,2,5,10,5,8,30,1
7718,74,66000,0,0,36,244,51,270,101,0,45,711,1,1,3,5,1,11,0
8605,57,46910,1,1,36,48,0,14,0,0,6,68,2,2,0,3,6,13,0
1646,49,25224,1,0,36,4,9,12,11,2,8,46,2,1,1,3,3,10,0
9206,53,77382,0,1,36,491,48,231,112,105,134,1121,2,5,7,12,1,27,1
10757,54,28420,1,0,36,4,2,5,2,0,0,13,1,1,0,2,6,10,0
6885,44,32952,1,0,36,38,0,12,3,1,1,55,1,2,0,3,7,13,0
907,46,46149,0,1,36,254,6,71,4,0,27,362,5,5,1,7,5,23,0
1150,122,83532,0,0,36,755,144,562,104,64,224,1853,1,4,6,4,1,16,1
3867,74,73059,0,1,36,410,112,420,0,82,71,1095,1,9,3,13,4,30,0
3859,74,73059,0,1,36,410,112,420,0,82,71,1095,1,9,3,13,4,30,0
3265,62,35701,0,0,36,21,1,9,7,3,5,46,1,1,0,3,6,11,0
4418,38,89616,0,0,36,671,47,655,145,111,15,1644,1,7,5,12,2,27,0
4611,51,105471,0,0,36,1009,181,104,202,21,207,1724,0,9,8,13,3,33,1
4530,73,78427,0,0,36,972,19,595,180,26,138,1930,3,3,7,10,3,26,1
7736,35,22518,1,0,36,11,7,12,2,2,27,61,2,2,1,2,5,12,1
9949,45,59809,0,2,36,598,16,141,32,41,49,877,3,3,3,6,8,23,0
942,39,39660,1,0,36,139,13,78,20,13,36,299,3,7,1,3,9,23,0
6181,71,52203,0,0,36,488,21,238,56,108,28,939,1,8,7,11,6,33,0
7660,48,35860,1,1,37,15,0,8,4,2,20,49,2,1,1,2,5,11,1
2055,48,35860,1,1,37,15,0,8,4,2,20,49,2,1,1,2,5,11,1
5107,48,35860,1,1,37,15,0,8,4,2,20,49,2,1,1,2,5,11,1
1626,48,35860,1,1,37,15,0,8,4,2,20,49,2,1,1,2,5,11,1
6428,71,76842,0,0,37,605,10,345,84,54,32,1130,1,1,8,7,0,17,0
9617,70,15033,0,0,37,0,4,5,6,0,4,19,1,1,0,3,3,8,0
4339,51,67353,0,1,37,702,17,151,0,8,35,913,5,5,6,12,2,30,0
7235,46,17003,1,0,37,2,5,12,4,8,7,38,3,2,0,4,5,14,0
8527,56,65735,1,1,37,239,7,119,4,15,11,395,5,6,2,6,7,26,0
1968,50,45684,1,0,37,5,1,5,10,0,7,28,1,1,0,2,7,11,0
9862,52,21918,1,0,37,1,6,7,11,5,3,33,2,2,0,3,6,13,0
11075,43,51267,1,1,37,183,2,64,7,2,12,270,4,3,3,5,4,19,0
6658,49,59868,0,1,37,771,51,154,54,10,154,1194,7,11,2,12,6,38,0
4552,30,51373,0,0,37,83,2,101,64,26,117,393,1,3,5,3,4,16,0
10377,63,46692,0,1,37,170,6,97,24,12,88,397,3,6,1,5,6,21,0
5336,50,157733,1,0,37,39,1,9,2,0,8,59,0,1,0,1,1,3,0
10350,71,54432,2,1,37,33,0,5,0,0,0,38,1,1,0,3,4,9,0
11071,37,79607,0,0,37,450,133,951,173,0,216,1923,1,3,6,6,1,17,0
11100,49,51813,1,1,37,51,2,7,0,1,2,63,2,2,0,3,7,14,0
6516,32,17487,1,0,37,0,0,1,7,4,6,18,1,1,0,2,7,11,0
1734,53,40706,2,1,37,59,0,11,4,2,5,81,4,3,0,4,7,18,0
2131,62,62859,0,1,37,1063,89,102,16,12,25,1307,4,9,4,6,6,29,0
6439,63,61074,0,1,37,789,0,133,0,28,152,1102,7,11,5,8,7,38,0
10591,52,43638,0,1,37,63,10,83,7,19,19,201,2,4,1,4,7,18,0
9797,65,58116,0,1,38,228,19,130,4,11,51,443,2,3,3,8,2,18,0
9336,52,62187,0,1,38,512,0,83,0,0,41,636,3,6,2,10,4,25,0
2174,67,46344,1,1,38,11,1,6,2,1,6,27,2,1,1,2,5,11,0
3197,41,77353,0,1,38,275,59,107,69,101,59,670,2,6,4,8,4,24,0
9185,55,69759,0,0,38,452,20,514,13,30,0,1029,3,4,6,5,3,21,0
905,35,21846,1,0,38,7,17,18,6,10,26,84,4,4,0,3,8,19,0
10858,46,76532,1,1,38,355,30,177,90,138,30,820,4,9,5,7,5,30,0
8925,56,70053,0,1,38,512,53,98,81,179,89,1012,3,8,5,10,5,31,0
2499,63,75342,0,1,38,204,97,97,21,118,26,563,1,5,2,10,4,22,0
1109,39,27590,1,0,38,6,0,5,0,0,1,12,1,1,0,2,7,11,0
326,48,51148,1,1,38,235,6,45,8,9,12,315,4,5,1,6,6,22,0
10967,58,33378,1,1,38,33,6,40,3,7,10,99,3,2,0,4,7,16,0
5370,48,32644,1,0,38,239,3,141,0,7,23,413,4,7,1,6,8,26,1
2098,52,33581,2,0,38,11,0,5,0,0,1,17,1,1,0,2,8,12,0
1773,43,12393,0,0,38,5,6,15,11,7,13,57,1,2,0,3,9,15,0
5036,37,42710,1,0,38,252,3,42,4,3,102,406,2,4,5,3,6,20,0
4856,64,82347,0,0,38,556,54,845,202,133,63,1853,1,7,7,10,3,28,1
8722,64,82347,0,0,38,556,54,845,202,133,63,1853,1,7,7,10,3,28,1
2156,66,22554,1,1,38,27,0,10,0,0,4,41,4,2,0,4,5,15,0
2569,34,17323,0,0,38,3,14,17,6,1,5,46,1,1,0,3,8,13,0
10151,61,62204,0,2,38,317,46,247,151,46,139,946,1,4,5,12,3,25,0
10473,65,78028,0,1,38,158,19,288,25,0,38,528,1,6,4,9,7,27,1
7079,59,63887,0,1,38,897,23,207,15,11,92,1245,5,9,6,12,6,38,0
6875,56,32727,0,0,38,167,13,180,86,13,70,529,2,7,3,5,8,25,0
6728,36,29103,1,0,38,16,0,17,6,3,6,48,2,1,0,3,9,15,0
2471,56,61482,0,0,39,48,58,68,16,66,43,299,1,3,2,6,2,14,0
49,51,20587,1,0,39,2,3,6,4,1,9,25,1,1,1,2,7,12,0
4973,51,20587,1,0,39,2,3,6,4,1,9,25,1,1,1,2,7,12,0
6387,45,52190,1,1,39,42,0,17,0,0,18,77,3,2,1,3,5,14,1
5866,47,48186,1,0,39,97,3,66,12,7,34,219,3,4,1,4,7,19,0
8523,53,19329,1,0,39,24,1,16,12,2,5,60,3,4,0,3,8,18,0
7901,50,34109,0,1,39,9,1,5,2,1,4,22,1,0,0,3,4,8,0
898,35,23477,1,0,39,38,15,54,3,8,29,147,3,3,0,4,8,18,0
10242,55,47472,1,1,39,56,0,11,0,0,8,75,2,2,0,4,5,13,0
5835,45,14849,1,0,39,21,2,28,3,2,9,65,3,2,0,4,8,17,0
6919,43,26224,1,0,39,4,7,15,13,9,15,63,3,2,1,3,6,15,0
6197,59,27238,1,1,39,37,0,17,0,0,3,57,3,3,0,3,9,18,0
4201,59,57967,0,1,39,229,7,137,4,0,91,468,5,4,2,8,5,24,0
5092,72,51569,0,1,39,380,0,47,6,0,34,467,4,7,1,7,8,27,1
6566,67,72550,1,1,39,826,50,317,50,38,38,1319,9,5,2,12,8,36,0
6613,51,44511,1,0,39,513,7,133,46,14,14,727,6,8,4,8,8,34,0
9094,66,62972,0,1,39,313,15,47,20,0,192,587,2,7,4,3,6,22,0
9847,66,62972,0,1,39,313,15,47,20,0,192,587,2,7,4,3,6,22,0
10767,32,77845,0,0,40,760,40,480,0,40,26,1346,1,3,5,12,1,22,1
7943,46,36663,1,0,40,18,0,6,3,3,5,35,1,1,1,3,2,8,0
1055,45,53204,1,1,40,29,0,8,2,0,6,45,1,1,0,3,4,9,0
1458,39,21059,1,0,40,8,3,19,3,3,8,44,3,3,0,3,6,15,0
8402,68,67087,0,1,40,329,35,222,130,35,43,794,2,7,5,8,4,26,0
6246,68,73892,0,0,40,703,102,601,0,58,43,1507,1,3,11,8,1,24,0
4654,29,75114,0,0,40,571,12,523,63,60,24,1253,1,3,10,5,2,21,0
6103,73,42192,0,0,40,40,15,15,17,6,7,100,1,2,1,3,4,11,0
8147,61,31454,1,1,40,28,0,11,0,0,9,48,3,2,0,3,8,16,0
10207,43,22775,1,0,40,5,1,8,0,0,1,15,1,1,0,2,8,12,0
4838,43,22775,1,0,40,5,1,8,0,0,1,15,1,1,0,2,8,12,0
10219,49,31590,1,0,40,6,2,15,6,6,3,38,1,1,0,3,8,13,0
2176,49,80134,1,0,40,1218,16,272,104,0,80,1690,2,5,3,6,6,22,1
9121,49,80134,1,0,40,1218,16,272,104,0,80,1690,2,5,3,6,6,22,1
5802,49,14188,0,0,40,2,7,11,16,12,27,75,1,2,0,4,6,13,0
10790,36,18169,1,0,40,9,0,5,0,0,7,21,1,1,0,2,8,12,0
178,65,62503,0,1,40,478,0,193,110,75,117,973,4,8,3,11,5,31,0
2308,67,46734,0,1,40,110,5,137,26,23,29,330,2,6,1,5,7,21,0
7431,30,68126,0,0,40,1332,17,311,23,51,86,1820,1,7,4,5,9,26,1
9405,67,52869,1,1,40,84,3,61,2,1,21,172,3,3,1,4,7,18,0
10525,35,26576,1,0,40,10,0,8,0,0,9,27,1,1,0,2,9,13,1
7503,45,75825,0,0,40,1032,105,779,137,105,51,2209,0,5,8,9,4,26,1
8783,71,57045,0,1,40,296,13,104,11,13,17,454,3,4,2,9,3,21,0
1403,46,34984,1,1,40,8,4,15,3,5,3,38,2,1,0,3,7,13,0
4643,48,27803,1,0,40,8,26,46,38,9,49,176,2,3,0,4,8,17,0
3463,46,69283,0,1,41,674,62,134,0,26,8,904,4,7,3,13,5,32,0
4055,29,18746,1,0,41,2,10,11,12,9,20,64,2,3,0,3,6,14,0
7010,56,70924,0,0,41,635,114,254,132,152,76,1363,1,6,6,7,3,23,1
4767,56,70924,0,0,41,635,114,254,132,152,76,1363,1,6,6,7,3,23,1
1927,48,69401,0,1,41,399,27,159,58,8,39,690,4,4,4,5,2,19,0
437,45,75012,0,0,41,294,142,218,164,58,151,1027,1,3,8,11,1,24,0
4331,43,85738,0,0,41,913,26,376,17,26,13,1371,1,3,6,11,1,22,1
4084,46,60934,0,1,41,224,155,155,192,93,54,873,2,6,4,11,4,27,0
8135,35,27161,1,0,41,7,4,23,7,0,11,52,1,1,0,3,7,12,0
9750,60,64325,0,1,41,731,60,353,78,12,73,1307,5,10,3,5,7,30,0
6682,48,18978,1,0,41,2,8,1,4,7,15,37,1,1,0,3,8,13,0
10581,44,41124,1,0,41,281,7,84,15,0,119,506,7,7,3,4,8,29,0
3710,37,39684,1,0,41,19,0,35,6,4,17,81,2,2,1,2,7,14,0
5207,58,53378,1,1,41,489,6,152,8,6,132,793,10,9,4,6,8,37,0
9360,39,37040,0,0,41,86,2,73,69,38,48,316,1,4,2,5,8,20,0
4679,44,78710,0,1,42,721,0,152,119,50,50,1092,3,7,6,12,4,32,0
1340,35,92910,0,0,42,551,137,792,179,103,33,1795,1,6,7,13,1,28,1
10839,45,36283,1,1,42,6,5,5,8,0,5,29,2,1,0,3,4,10,0
5303,47,79632,0,0,42,471,0,510,99,21,12,1113,1,6,4,9,2,22,0
9829,43,28587,1,0,42,22,4,17,12,10,13,78,3,2,0,4,6,15,0
10469,40,88325,0,0,42,519,71,860,93,27,53,1623,1,6,2,9,2,20,0
3602,63,51412,0,1,42,140,3,29,4,5,14,195,2,3,2,4,4,15,0
4756,69,63998,0,0,42,176,29,818,0,33,112,1168,1,7,6,11,4,29,0
8181,43,38593,1,0,42,51,12,49,17,24,24,177,3,4,1,3,8,19,0
6958,44,27889,1,0,42,14,0,4,0,0,8,26,1,1,1,2,6,11,0
10856,41,45889,0,1,42,31,0,6,0,1,8,46,1,1,0,3,6,11,0
3321,54,56575,0,2,42,421,5,90,0,16,10,542,3,7,3,7,5,25,0
5394,42,16014,1,1,42,3,9,4,7,8,7,38,4,1,1,4,3,13,0
433,63,61331,1,1,42,534,5,47,0,5,41,632,5,11,1,6,8,31,0
6320,45,70893,0,0,42,768,44,561,77,44,14,1508,1,6,6,10,3,26,0
5376,42,2447,1,0,42,1,1,1725,1,1,1,1730,15,0,28,0,1,44,0
1867,64,64849,0,0,42,652,48,350,94,84,108,1336,1,9,3,6,5,24,0
4324,32,42387,1,0,42,235,0,235,19,4,191,684,5,8,1,7,8,29,0
3661,26,80617,0,0,42,594,51,631,72,55,32,1435,1,4,6,8,2,21,0
521,36,54006,1,0,42,174,77,203,6,24,97,581,2,8,1,7,7,25,0
10403,43,16531,1,0,43,2,13,6,7,5,11,44,3,3,0,3,7,16,0
7186,55,30843,1,1,43,24,0,2,0,0,9,35,2,1,1,2,5,11,1
4329,37,18988,1,0,43,6,0,6,2,1,1,16,2,1,0,3,7,13,0
4394,56,81051,0,0,43,1142,29,249,38,29,14,1501,1,5,5,12,2,25,1
1717,33,39747,1,0,43,80,15,93,20,13,52,273,3,5,1,4,8,21,0
1016,62,34554,0,1,43,41,1,6,2,0,5,55,2,2,0,3,6,13,0
3783,62,52854,1,1,43,105,0,10,0,1,0,116,2,2,1,4,5,14,0
5848,51,81205,0,0,43,724,74,929,97,55,130,2009,1,5,6,7,2,21,1
10727,51,69084,1,0,43,1181,107,199,39,30,30,1586,2,7,3,13,8,33,0
5299,51,69084,1,0,43,1181,107,199,39,30,30,1586,2,7,3,13,8,33,0
6872,47,65352,0,1,43,284,3,84,4,7,23,405,2,4,2,8,4,20,0
1143,49,22063,1,0,43,7,10,13,3,11,11,55,2,2,0,3,7,14,0
10381,42,47691,0,1,43,14,0,3,0,0,4,21,1,1,0,2,6,10,0
11007,53,29187,1,0,43,26,0,6,0,0,2,34,1,1,0,3,8,13,0
9145,49,72504,0,1,43,604,26,470,123,161,94,1478,2,5,9,6,2,24,0
5267,51,33986,1,0,43,16,2,18,2,1,5,44,1,1,0,3,7,12,0
9738,35,42386,1,0,43,65,4,16,0,4,11,100,1,3,0,3,8,15,0
10212,35,42386,1,0,43,65,4,16,0,4,11,100,1,3,0,3,8,15,0
10010,68,36957,1,1,43,100,2,16,2,1,31,152,4,3,2,2,9,20,0
10069,33,13724,1,0,43,2,7,5,2,15,27,58,1,2,0,2,9,14,1
2694,54,42664,0,1,44,21,0,3,0,0,0,24,1,1,0,3,6,11,0
10613,63,37334,1,1,44,26,1,16,2,2,15,62,4,3,0,4,4,15,0
4646,70,78497,0,0,44,207,26,447,75,0,223,978,1,5,7,12,2,27,1
6935,70,78497,0,0,44,207,26,447,75,0,223,978,1,5,7,12,2,27,1
5596,65,58821,0,1,44,513,14,154,19,0,28,728,1,9,2,9,6,27,0
1044,68,58398,0,0,44,299,5,201,21,21,49,596,3,5,4,8,4,24,0
9274,60,80950,0,0,44,525,147,112,219,147,63,1213,1,6,7,9,2,25,1
9076,41,30732,1,0,44,155,1,25,0,1,3,185,4,4,1,4,8,21,0
4947,55,89572,0,0,44,606,24,974,197,194,64,2059,1,7,7,9,4,28,1
10176,53,57107,0,1,44,159,0,120,0,0,137,416,7,4,4,8,8,31,1
3507,51,76467,1,0,44,676,161,426,210,44,58,1575,2,2,5,5,6,20,0
10341,73,51315,0,0,45,68,28,39,16,30,41,222,1,2,2,5,2,12,0
2639,55,43602,1,1,45,19,5,12,10,3,19,68,3,3,1,2,6,15,0
6201,43,38643,1,1,45,22,2,14,0,1,10,49,2,2,0,3,7,14,0
7397,70,49090,0,1,45,494,5,82,7,0,100,688,3,7,2,9,7,28,0
2181,51,70617,0,0,45,353,61,753,40,46,27,1280,1,3,3,7,2,16,0
1204,51,67536,0,1,45,1253,0,447,23,71,35,1829,3,11,5,11,8,38,1
1170,46,27573,1,0,45,50,15,110,39,15,15,244,4,5,1,4,8,22,0
8812,42,13533,1,0,45,12,3,8,8,0,17,48,2,2,0,3,7,14,0
4690,68,50725,0,1,45,443,10,75,0,10,48,586,4,8,1,8,8,29,0
1715,43,25851,1,0,45,9,4,18,7,5,5,48,2,2,0,3,7,14,0
10821,43,57113,1,1,45,182,4,33,0,2,42,263,6,4,1,5,7,23,0
6543,76,62847,0,0,45,521,168,706,80,76,61,1612,1,3,6,4,2,16,0
7119,39,68627,0,0,45,395,15,263,60,54,38,825,1,2,3,6,1,13,0
3518,38,25271,1,0,45,10,1,18,10,4,7,50,1,1,1,2,9,14,0
1245,55,63810,0,1,45,977,12,253,16,12,101,1371,4,4,3,12,8,31,1
2561,55,63810,0,1,45,977,12,253,16,12,101,1371,4,4,3,12,8,31,1
9624,63,65488,0,0,46,603,45,207,36,18,54,963,1,3,4,6,1,15,0
10509,66,36927,1,1,46,51,0,16,0,0,4,71,2,3,0,3,8,16,0
7629,44,22108,1,1,46,5,3,9,6,2,6,31,2,2,0,3,7,14,0
7875,72,72025,0,0,46,967,0,617,43,50,0,1677,1,4,8,13,2,28,1
2815,46,33183,1,0,46,7,5,39,17,15,37,120,2,4,0,3,7,16,0
2936,39,23661,1,0,46,18,0,4,0,0,1,23,1,1,0,3,7,12,0
3665,44,25315,1,0,46,1,9,8,11,3,22,54,3,3,0,3,8,17,0
10888,60,45938,0,0,46,273,11,178,62,83,29,636,2,8,4,6,6,26,0
6637,33,66951,0,0,46,277,162,305,173,76,124,1117,1,3,4,7,1,16,0
5077,42,77298,0,1,46,425,115,292,23,35,79,969,1,6,6,11,3,27,0
6173,42,77298,0,1,46,425,115,292,23,35,79,969,1,6,6,11,3,27,0
3969,47,43018,0,1,46,35,4,17,7,6,64,133,1,2,2,2,5,12,0
4580,52,75759,0,0,46,1394,22,708,89,91,182,2486,1,9,7,9,5,31,1
663,32,33996,0,0,46,40,2,15,8,0,6,71,1,1,1,3,4,10,0
8299,32,33996,0,0,46,40,2,15,8,0,6,71,1,1,1,3,4,10,0
8945,51,54137,0,1,46,171,0,11,0,1,20,203,2,4,1,4,6,17,0
10870,54,61223,0,1,46,709,43,182,42,118,247,1341,2,9,3,4,5,23,0
1184,53,69674,0,2,46,554,41,215,11,0,24,845,3,10,2,10,5,30,0
6141,49,49494,1,0,46,191,9,97,0,6,82,385,2,6,1,5,7,21,0
8825,59,51195,1,1,46,230,14,156,82,24,58,564,8,9,2,5,8,32,0
2217,46,37284,1,1,46,11,1,2,2,1,6,23,1,0,0,3,6,10,0
4102,46,37284,1,1,46,11,1,2,2,1,6,23,1,0,0,3,6,10,0
4653,43,42011,1,0,46,131,0,16,2,1,39,189,4,3,1,4,8,20,0
10092,67,70044,0,1,46,1073,0,250,153,14,14,1504,4,7,10,5,5,31,0
5788,49,46053,1,0,46,56,10,92,19,7,25,209,3,3,2,4,5,17,0
4669,40,24480,1,0,46,4,19,9,28,25,17,102,3,3,0,4,7,17,0
6295,44,54233,0,1,46,652,8,158,21,0,142,981,4,11,6,5,8,34,0
7453,67,36130,0,1,46,157,43,127,68,56,37,488,6,3,8,4,4,25,1
10841,46,56559,0,1,46,226,22,133,41,31,31,484,3,4,3,8,4,22,0
821,29,92859,0,0,46,962,61,921,52,61,20,2077,1,5,4,12,2,24,0
3933,41,44010,1,0,46,186,36,234,86,72,48,662,6,10,2,6,9,33,0
1225,58,80124,0,0,47,483,84,398,205,84,241,1495,1,3,7,8,1,20,1
7059,58,80124,0,0,47,483,84,398,205,84,241,1495,1,3,7,8,1,20,1
5633,41,50183,1,1,47,97,12,84,13,10,15,231,7,3,1,6,5,22,0
843,50,64722,1,0,47,303,0,280,60,147,15,805,4,8,2,11,6,31,0
6211,45,37395,1,0,47,18,0,9,0,1,11,39,1,1,0,3,6,11,0
7007,53,29543,2,0,47,17,3,18,3,4,18,63,2,3,1,2,7,15,0
9671,53,19514,1,1,47,14,3,21,2,1,28,69,4,3,1,2,8,18,1
8975,53,19514,1,1,47,14,3,21,2,1,28,69,4,3,1,2,8,18,1
6616,46,59481,0,1,47,178,3,85,71,66,58,461,2,3,3,8,2,18,0
6248,74,91712,0,0,47,1276,24,746,94,29,48,2217,0,9,7,11,3,30,1
7428,46,80144,0,0,47,240,132,445,250,192,108,1367,1,3,7,8,1,20,0
3075,49,59973,0,0,47,130,30,168,20,34,0,382,1,3,4,7,1,16,0
2937,47,68352,0,1,47,614,16,132,43,33,33,871,3,8,5,9,6,31,0
203,46,81169,0,0,47,1288,20,613,80,61,27,2089,1,5,7,9,2,24,0
2021,46,61456,0,1,47,563,76,384,84,192,89,1388,4,6,10,13,4,37,0
880,55,22634,0,0,47,2,23,11,8,6,46,96,1,2,1,2,8,14,0
524,55,22634,0,0,47,2,23,11,8,6,46,96,1,2,1,2,8,14,0
10837,46,23957,1,0,47,2,1,18,20,11,16,68,1,2,0,3,6,12,0
7011,48,33471,1,0,47,43,2,27,0,9,12,93,3,3,0,4,7,17,0
4184,71,52157,0,1,48,189,2,29,3,2,40,265,2,3,2,5,4,16,0
7679,36,30298,0,0,48,6,3,12,6,1,0,28,1,1,1,3,3,9,0
7485,71,56551,1,1,48,67,4,32,17,2,16,138,3,2,1,4,4,14,0
7530,71,56551,1,1,48,67,4,32,17,2,16,138,3,2,1,4,4,14,0
4369,64,65487,0,0,48,240,67,500,199,0,163,1169,3,3,5,6,2,19,0
10652,64,65487,0,0,48,240,67,500,199,0,163,1169,3,3,5,6,2,19,0
286,69,44213,1,1,48,95,11,35,0,4,7,152,4,2,1,5,6,18,0
5922,47,40344,0,1,48,210,0,6,0,0,2,218,2,4,1,5,7,19,0
7250,43,57867,1,0,48,344,35,178,15,23,17,612,7,7,2,9,6,31,0
2478,48,25410,1,0,48,2,2,4,13,13,4,38,1,1,0,4,4,10,0
1160,51,13260,1,1,48,9,4,17,10,2,7,49,4,3,0,3,8,18,0
9214,30,42691,0,0,48,179,2,64,38,17,58,358,1,5,1,6,5,18,0
273,51,36138,1,1,48,130,0,16,0,0,5,151,5,3,1,4,7,20,1
851,49,57136,1,1,48,306,5,109,21,109,92,642,9,5,2,10,6,32,0
9729,66,58275,1,1,48,189,10,253,56,43,64,615,6,8,2,7,7,30,0
9665,64,54237,0,1,48,267,3,30,4,0,57,361,4,5,2,5,6,22,0
2620,47,34596,1,0,48,14,0,2,0,0,7,23,1,1,0,2,8,12,0
8254,47,34596,1,0,48,14,0,2,0,0,7,23,1,1,0,2,8,12,0
3852,60,74881,1,1,48,505,72,270,36,27,54,964,4,9,2,12,5,32,0
1000,60,74881,1,1,48,505,72,270,36,27,54,964,4,9,2,12,5,32,0
3099,51,44267,1,1,48,183,5,65,3,5,49,310,5,5,2,4,9,25,0
6318,33,68487,0,0,48,758,12,385,33,89,89,1366,1,9,7,13,4,34,0
5396,33,68487,0,0,48,758,12,385,33,89,89,1366,1,9,7,13,4,34,0
7966,62,80982,1,1,48,505,137,401,104,22,22,1191,3,11,5,11,5,35,0
454,41,69508,1,0,48,824,32,162,42,32,43,1135,2,11,4,11,6,34,0
309,60,63342,0,1,48,918,21,118,13,10,21,1101,3,8,3,5,6,25,1
3571,60,63342,0,1,48,918,21,118,13,10,21,1101,3,8,3,5,6,25,1
8395,60,82014,0,0,48,980,37,265,35,163,31,1511,1,3,6,12,6,28,0
2591,62,76320,0,1,49,526,35,214,69,53,35,932,2,6,3,4,2,17,0
1640,67,64587,1,1,49,66,0,16,0,6,20,108,2,1,1,4,3,11,0
810,46,74190,0,1,49,151,81,86,168,91,64,641,2,4,2,11,2,21,0
9423,42,32765,1,0,49,13,3,17,7,3,3,46,2,2,0,4,5,13,0
89,46,22212,1,0,49,5,9,20,6,8,21,69,2,2,0,4,6,14,0
5294,32,18358,1,0,49,6,8,19,16,4,4,57,3,3,0,4,7,17,0
1321,47,26067,1,0,49,22,2,18,0,2,12,56,3,3,0,3,8,17,0
2686,52,22390,0,0,49,0,1,4,15,1,5,26,1,1,0,2,7,11,0
1215,43,70440,0,0,49,690,117,499,76,102,88,1572,1,5,10,7,3,26,1
9283,43,60199,1,2,49,8,1,7,2,0,0,18,1,0,0,3,4,8,0
3120,40,38547,1,0,49,6,1,10,0,1,4,22,1,1,0,2,8,12,0
5868,41,19107,1,0,49,2,4,9,10,5,16,46,2,1,0,3,7,13,0
8143,36,37929,0,0,49,202,2,46,3,2,10,265,2,4,2,5,7,20,1
3479,71,16813,0,0,49,4,8,11,12,2,13,50,1,2,0,3,7,13,1
7214,64,62187,0,0,49,792,0,275,45,45,126,1283,1,4,8,5,3,21,0
5543,55,57811,0,1,49,545,7,114,37,21,78,802,5,7,2,11,5,30,1
9347,65,50943,0,1,49,31,0,7,2,0,6,46,1,1,0,3,5,10,0
10160,65,50943,0,1,49,31,0,7,2,0,6,46,1,1,0,3,5,10,0
1406,46,53201,1,1,49,280,7,81,20,0,27,415,8,6,3,5,7,29,0
7019,58,54414,1,1,49,109,18,16,24,26,18,211,4,3,1,5,4,17,0
2157,49,26290,1,1,49,15,8,16,11,5,22,77,4,2,0,4,6,16,0
8939,62,61250,0,1,49,382,138,65,60,26,59,730,6,5,2,12,5,30,0
10250,74,28389,0,0,49,1,5,3,7,4,8,28,1,1,0,2,7,11,0
1272,56,55250,0,1,49,664,58,83,32,0,66,903,4,7,5,10,5,31,0
3007,55,37758,1,1,49,27,2,10,0,0,1,40,2,1,0,3,8,14,0
5513,55,37758,1,1,49,27,2,10,0,0,1,40,2,1,0,3,8,14,0
679,64,37633,1,1,49,13,4,20,0,0,1,38,2,1,0,3,9,15,0
8876,58,33629,1,1,49,132,0,16,0,0,4,152,5,3,1,4,9,22,0
10827,54,36947,1,1,49,88,3,21,4,1,29,146,4,3,0,4,9,20,0
7300,69,69142,0,1,50,448,4,34,6,4,39,535,3,8,1,7,5,24,1
4268,62,53154,0,1,50,129,0,21,0,1,7,158,1,3,1,4,4,13,0
4603,61,65695,0,1,50,371,32,189,0,58,6,656,2,5,4,10,4,25,0
8659,69,69805,0,1,50,750,71,174,13,10,20,1038,2,6,8,11,2,29,0
10708,43,36975,1,0,50,10,6,11,0,4,2,33,1,1,0,3,7,12,0
1176,48,26228,1,0,50,2,6,4,3,1,9,25,1,1,0,2,8,12,0
10380,49,37787,1,0,50,40,1,40,4,3,18,106,1,3,0,3,8,15,0
7037,47,37087,1,0,50,194,55,134,15,0,3,401,3,4,2,8,6,23,0
11096,69,57247,0,1,50,99,4,32,37,54,6,232,2,2,1,7,2,14,0
6374,67,36930,0,1,50,223,2,31,0,2,39,297,5,5,2,4,8,24,0
5552,58,48721,1,1,50,81,18,113,47,13,21,293,6,4,2,5,6,23,0
2245,52,43641,1,1,50,57,2,51,4,2,23,139,3,2,1,4,6,16,0
6200,70,75903,0,1,50,340,108,185,130,38,100,901,2,6,6,9,3,26,0
9904,65,71391,0,1,50,336,123,274,46,123,141,1043,5,6,5,12,3,31,0
10031,45,16927,1,1,50,20,2,23,3,1,4,53,5,3,0,4,8,20,0
6642,60,27215,2,1,50,30,5,22,8,9,28,102,4,2,1,4,6,17,0
10882,45,53858,0,1,50,407,53,221,58,150,26,915,4,4,3,6,4,21,0
5636,58,30983,0,0,50,51,4,50,12,1,49,167,1,4,0,3,8,16,0
8692,69,43462,1,1,50,90,17,97,15,6,15,240,6,4,1,5,8,24,0
8091,65,63943,0,1,50,423,184,368,13,97,21,1106,1,6,4,6,5,22,0
8080,35,26816,0,0,50,5,1,6,3,4,3,22,1,0,0,3,4,8,0
8370,45,75484,0,1,50,378,97,259,197,194,34,1159,2,7,3,6,4,22,0
4550,55,33564,0,1,51,61,0,3,0,0,7,71,1,1,1,3,5,11,0
3381,68,54348,1,1,51,70,0,16,0,0,4,90,2,2,0,4,6,14,0
10556,62,54984,0,1,51,173,13,131,32,3,6,358,4,6,1,6,7,24,1
9467,37,34738,1,0,51,3,2,10,3,0,2,20,1,1,0,3,6,11,0
2891,58,68118,0,1,51,595,23,123,10,23,154,928,2,8,9,4,6,29,0
5011,58,68118,0,1,51,595,23,123,10,23,154,928,2,8,9,4,6,29,0
8140,48,22682,1,0,51,10,14,29,4,2,36,95,3,2,1,4,4,14,0
11039,46,51948,0,1,51,82,33,54,71,30,41,311,2,5,2,4,5,18,0
78,52,25293,1,0,51,15,0,11,0,2,9,37,1,1,1,2,8,13,0
5517,52,25293,1,0,51,15,0,11,0,2,9,37,1,1,1,2,8,13,0
5290,57,41551,1,1,51,220,0,33,3,0,23,279,5,5,1,5,8,24,0
4128,59,56067,0,1,51,517,12,54,16,6,120,725,2,7,4,7,5,25,0
8534,69,67433,0,2,51,615,28,259,12,48,30,992,4,6,5,13,4,32,1
9592,38,22010,1,0,51,11,2,9,3,0,8,33,2,2,0,3,8,15,0
8957,69,64831,1,1,51,480,86,249,75,86,144,1120,8,6,3,5,6,28,0
9308,67,62820,0,0,51,398,61,265,138,61,53,976,1,3,4,6,1,15,0
544,67,62820,0,0,51,398,61,265,138,61,53,976,1,3,4,6,1,15,0
5989,62,78353,0,1,51,752,122,476,39,153,34,1576,1,10,2,11,8,32,0
635,55,57183,1,1,51,464,5,64,7,0,70,610,8,9,1,7,8,33,0
6673,56,23478,0,0,51,28,6,27,12,17,39,129,1,3,0,3,8,15,0
1710,43,30168,1,0,51,154,20,66,0,12,27,279,7,6,1,4,9,27,0
523,32,37155,1,0,51,23,0,26,7,15,3,74,1,2,0,4,5,12,0
8977,36,16581,0,0,51,1,3,4,2,3,11,24,1,0,0,3,4,8,0
9736,41,41850,1,1,51,53,5,19,2,13,4,96,3,3,0,3,8,17,0
1544,54,81380,0,0,51,741,68,689,224,68,103,1893,1,4,2,10,2,19,0
6575,40,56386,1,1,51,230,48,214,13,32,75,612,8,9,1,7,9,34,0
6147,50,25818,1,0,51,5,2,8,2,2,9,28,1,0,1,2,7,11,0
6354,37,15345,1,0,51,5,2,16,3,2,19,47,2,1,1,2,8,14,0
4769,44,57954,1,1,52,456,4,24,0,0,9,493,7,8,2,6,7,30,1
7540,69,50300,0,1,52,143,15,60,24,23,5,270,2,2,1,8,2,15,0
5247,66,38725,1,1,52,31,0,6,2,1,5,45,2,1,0,4,4,11,0
5987,32,10404,1,0,52,2,2,11,10,6,12,43,2,1,0,4,5,12,0
9960,30,26868,1,0,52,0,0,1,8,3,2,14,1,1,0,2,7,11,0
10972,72,72298,0,0,52,625,35,169,58,17,35,939,1,4,3,6,1,15,1
1399,63,72905,0,0,52,407,114,445,181,165,203,1515,1,3,7,9,1,21,1
2698,45,47025,0,1,52,254,7,108,20,0,26,415,3,6,3,5,6,23,0
6340,36,29938,1,0,52,3,3,7,0,2,11,26,2,1,0,3,6,12,0
4107,73,46681,0,2,52,269,15,69,15,19,38,425,2,4,6,4,5,21,0
10906,73,46681,0,2,52,269,15,69,15,19,38,425,2,4,6,4,5,21,0
2557,51,29548,1,0,52,7,1,6,3,1,11,29,1,1,1,2,4,9,1
8786,65,62058,0,1,52,301,7,74,10,0,58,450,4,6,1,7,6,24,0
6119,58,36736,1,1,52,10,0,3,0,0,4,17,1,1,0,2,6,10,0
2980,69,8820,1,1,52,12,0,13,4,2,4,35,4,3,0,3,8,18,0
3850,58,14918,0,1,52,3,3,3,15,4,15,43,1,1,0,3,6,11,0
1077,47,56715,0,0,52,258,105,239,237,172,9,1020,1,7,3,4,4,19,0
9733,43,24882,1,0,52,1,4,10,29,0,36,80,1,1,1,2,6,11,1
8462,43,24882,1,0,52,1,4,10,29,0,36,80,1,1,1,2,6,11,1
4764,69,40442,1,1,52,45,12,52,25,22,13,169,4,3,1,4,7,19,0
2223,56,64176,0,1,52,1215,33,249,64,116,149,1826,8,8,9,8,6,39,0
7788,38,23536,1,0,53,6,0,3,0,0,1,10,1,0,0,3,3,7,0
5827,63,35246,1,1,53,36,0,12,2,2,10,62,4,3,1,3,5,16,0
2958,43,28442,2,0,53,19,3,10,11,8,6,57,3,2,1,4,4,14,0
4954,65,48195,1,1,53,106,27,68,52,7,5,265,6,4,2,5,6,23,0
3139,39,74116,0,0,53,871,111,704,145,55,166,2052,1,4,4,10,2,21,1
9952,74,78093,0,0,53,368,32,639,13,43,10,1105,1,4,7,5,1,18,0
8180,69,59354,1,1,53,233,2,53,3,5,14,310,3,6,1,5,6,21,0
3276,45,36301,1,0,53,11,12,35,3,5,12,78,1,3,0,3,7,14,0
4994,78,77598,0,0,53,1193,33,281,129,66,33,1735,1,7,5,13,3,29,1
3598,49,62710,0,1,53,441,35,83,7,29,11,606,4,4,2,12,4,26,0
945,56,36317,0,1,53,87,3,25,3,2,13,133,2,3,0,4,7,16,0
5048,50,42767,2,0,53,20,6,43,19,5,38,131,1,3,1,2,8,15,0
6214,39,43815,1,0,53,14,10,29,4,7,15,79,1,2,0,3,6,12,0
6230,50,44421,1,1,53,110,5,59,7,1,7,189,5,5,0,4,8,22,0
2968,78,48948,0,0,53,437,8,206,160,49,42,902,2,7,10,5,6,30,1
8800,78,48948,0,0,53,437,8,206,160,49,42,902,2,7,10,5,6,30,1
1907,71,63120,0,1,53,965,69,279,54,41,69,1477,5,8,4,9,7,33,0
10478,71,55517,1,1,53,483,0,108,0,6,36,633,5,11,1,6,9,32,0
4188,64,36864,0,1,53,204,5,39,17,0,89,354,3,5,2,4,8,22,0
2225,44,82582,0,0,54,510,120,550,156,40,241,1617,1,4,9,7,1,22,1
4790,63,79803,0,1,54,574,8,216,21,16,33,868,1,4,3,5,1,14,0
1131,54,52569,0,1,54,85,0,3,0,0,7,95,1,2,0,4,3,10,0
202,73,82032,0,0,54,332,194,377,149,125,57,1234,0,4,6,7,1,18,0
9589,73,82032,0,0,54,332,194,377,149,125,57,1234,0,4,6,7,1,18,0
3900,49,65685,0,1,54,642,14,49,0,7,57,769,1,9,2,9,5,26,0
9958,49,65685,0,1,54,642,14,49,0,7,57,769,1,9,2,9,5,26,0
8955,64,40451,0,2,54,35,0,4,0,0,10,49,1,1,1,2,5,10,1
10033,48,31163,1,0,54,2,3,10,11,2,10,38,1,1,0,3,6,11,0
5751,48,31163,1,0,54,2,3,10,11,2,10,38,1,1,0,3,6,11,0
3308,69,35704,1,1,54,30,9,12,2,11,30,94,3,2,0,4,4,13,0
7297,48,7500,1,0,54,5,3,10,12,7,20,57,4,3,1,3,7,18,0
8008,38,36075,1,0,54,46,0,30,12,1,30,119,1,2,0,4,6,13,0
1232,39,70038,0,0,54,587,54,348,71,54,130,1244,1,4,4,8,2,19,0
2345,39,70038,0,0,54,587,54,348,71,54,130,1244,1,4,4,8,2,19,0
1628,50,71796,0,0,54,354,21,311,167,75,32,960,1,9,3,4,4,21,0
5081,54,47821,1,1,54,9,0,16,6,6,10,47,1,1,0,3,8,13,0
839,46,45503,1,0,54,97,4,44,6,1,18,170,1,3,1,4,5,14,0
3706,43,28647,1,0,54,19,8,29,0,12,26,94,1,2,2,2,7,14,1
5154,49,37760,1,0,54,26,3,13,2,10,0,54,1,2,0,3,6,12,0
8584,69,85431,0,0,54,376,53,462,168,53,53,1165,1,2,7,7,0,17,0
6583,66,72635,0,0,54,390,22,323,104,35,107,981,1,6,8,6,3,24,1
3433,66,72635,0,0,54,390,22,323,104,35,107,981,1,6,8,6,3,24,1
10486,73,77142,0,0,54,476,75,162,29,151,97,990,1,4,4,8,2,19,0
8687,43,53172,0,1,54,121,62,90,68,20,125,486,3,2,3,8,3,19,0
7842,53,36065,1,1,54,18,7,34,10,2,3,74,3,3,0,3,8,17,0
3749,48,73926,0,0,54,627,91,597,159,91,15,1580,1,6,5,12,3,27,0
1331,44,35790,1,0,54,12,6,20,30,1,3,72,2,2,0,3,7,14,0
5995,59,39552,1,1,54,165,3,147,4,24,41,384,7,6,2,5,8,28,0
8985,57,68316,0,1,54,806,80,161,120,11,33,1211,5,10,7,10,6,38,0
2798,44,102160,0,0,54,763,29,138,76,176,58,1240,0,7,9,10,4,30,1
7108,56,51390,1,1,54,205,20,47,23,2,56,353,6,5,2,5,5,23,0
2781,40,72066,0,0,55,1003,34,536,134,51,34,1792,1,4,6,6,2,19,1
3623,45,21675,1,0,55,4,0,16,17,4,4,45,3,4,0,3,7,17,0
194,56,48006,1,1,55,23,0,11,3,2,2,41,1,1,0,3,6,11,0
10833,46,65106,0,1,55,790,19,133,12,0,19,973,3,8,3,13,6,33,1
2315,61,58401,0,1,55,10,0,11,17,29,29,96,1,1,2,2,4,10,0
6336,61,29315,1,1,55,13,2,14,8,7,4,48,4,2,0,4,6,16,0
10738,70,49389,1,1,55,40,0,19,2,1,3,65,1,2,0,3,7,13,0
8286,56,51717,0,1,55,98,1,17,0,1,5,122,1,3,0,4,7,15,1
2166,61,46779,1,1,55,12,1,3,0,0,7,23,1,0,1,2,4,8,0
10691,61,28520,1,1,55,11,0,10,0,2,20,43,1,1,1,2,6,11,0
9739,58,34377,0,1,55,62,0,22,3,1,26,114,2,2,2,2,7,15,0
1829,60,54959,0,1,55,1148,0,60,0,0,24,1232,3,9,5,4,7,28,1
6260,66,82384,0,0,55,984,51,432,180,120,190,1957,1,3,10,13,1,28,1
10448,65,46998,0,1,55,172,41,86,45,6,27,377,5,5,3,5,7,25,1
1343,53,58554,1,1,55,368,24,68,38,0,88,586,6,8,2,6,7,29,0
4749,53,58554,1,1,55,368,24,68,38,0,88,586,6,8,2,6,7,29,0
531,67,57333,0,1,55,941,14,397,76,58,176,1662,11,8,5,9,6,39,0
6905,27,80685,0,0,55,241,45,604,34,26,54,1004,1,6,4,10,2,23,0
1045,56,52117,0,1,55,112,10,107,30,0,20,279,2,5,2,4,7,20,0
4012,49,62220,0,1,55,799,12,375,16,12,12,1226,5,7,6,5,6,29,0
5529,75,64014,2,1,56,406,0,30,0,0,8,444,7,8,2,5,7,29,1
4001,75,64014,2,1,56,406,0,30,0,0,8,444,7,8,2,5,7,29,1
10420,66,46390,0,1,56,95,14,64,2,9,38,222,1,4,2,3,7,17,0
7723,42,75507,0,0,56,709,93,374,104,80,80,1440,1,8,6,6,3,24,0
2963,42,75507,0,0,56,709,93,374,104,80,80,1440,1,8,6,6,3,24,0
10634,70,59412,0,0,56,90,67,165,30,43,11,406,1,4,2,8,3,18,0
5180,53,50616,0,1,56,128,0,16,0,1,4,149,2,4,0,4,7,17,0
6866,52,35924,1,1,56,8,0,14,2,3,7,34,1,1,0,3,5,10,0
1328,39,57937,0,1,56,261,42,144,55,48,133,683,3,4,4,9,3,23,0
1139,37,73356,0,0,56,1050,14,322,0,14,112,1512,1,5,11,5,2,24,1
4961,47,21255,1,0,56,29,0,25,2,2,3,61,4,2,1,4,4,15,0
5177,47,58494,0,1,56,298,7,68,4,0,19,396,2,6,2,6,6,22,0
2075,52,72460,0,0,56,377,10,540,80,30,10,1047,1,3,5,7,1,17,0
3428,30,68682,0,0,56,919,0,505,99,30,45,1598,1,4,9,10,2,26,0
4500,30,68682,0,0,56,919,0,505,99,30,45,1598,1,4,9,10,2,26,0
7369,40,36959,1,0,56,25,6,25,6,0,0,62,2,2,0,3,8,15,0
4381,50,46463,1,1,56,163,2,40,8,11,11,235,7,3,1,6,6,23,0
9964,42,61825,0,1,56,162,50,100,55,30,27,424,1,4,2,8,4,19,0
1630,42,61825,0,1,56,162,50,100,55,30,27,424,1,4,2,8,4,19,0
5012,32,28691,1,0,56,5,4,13,8,0,4,34,1,1,0,3,8,13,0
6918,32,28691,1,0,56,5,4,13,8,0,4,34,1,1,0,3,8,13,0
7822,45,54058,0,1,56,198,18,252,32,108,54,662,2,4,6,8,3,23,0
10156,46,84196,0,1,56,215,63,507,231,31,190,1237,1,8,4,7,3,23,0
3033,58,38620,0,0,56,112,17,44,34,22,89,318,1,2,5,3,3,14,0
4119,58,38620,0,0,56,112,17,44,34,22,89,318,1,2,5,3,3,14,0
11110,48,3502,1,0,56,2,1,1,0,0,1,5,0,0,0,0,14,14,0
332,64,47743,0,1,56,198,2,43,0,12,20,275,3,4,1,6,6,20,1
737,72,80360,0,0,56,1493,86,454,112,43,43,2231,2,4,4,5,2,17,1
10319,50,66303,0,1,56,1090,12,96,16,12,60,1286,4,3,4,11,8,30,1
2683,52,52413,0,2,56,295,106,271,75,98,65,910,4,6,4,12,6,32,0
3445,65,60714,0,0,56,216,162,224,101,92,162,957,2,7,4,10,5,28,0
10913,37,31385,1,0,56,3,2,12,0,1,9,27,1,1,0,2,8,12,1
4427,26,83257,0,0,56,536,27,590,38,107,67,1365,1,5,10,12,6,34,1
8717,46,80427,0,1,56,1149,71,449,69,71,26,1835,1,11,8,8,5,33,0
2066,72,38823,0,1,56,70,0,11,2,8,23,114,1,2,1,3,6,13,0
3340,44,42014,1,0,56,244,15,108,4,15,50,436,6,7,1,6,8,28,0
8685,44,42014,1,0,56,244,15,108,4,15,50,436,6,7,1,6,8,28,0
4149,73,76140,0,0,57,586,66,653,17,0,26,1348,1,5,9,6,2,23,0
8726,57,41713,1,1,57,77,8,44,10,10,25,174,5,3,1,4,6,19,0
2295,67,62670,0,1,57,539,30,92,80,46,38,825,1,5,3,13,3,25,0
3283,49,70932,0,1,57,200,193,100,46,185,185,909,2,6,2,12,3,25,0
1915,70,78939,0,0,57,794,115,243,150,0,205,1507,1,8,5,6,3,23,0
800,61,44512,1,1,57,23,1,6,0,0,2,32,2,1,0,3,4,10,0
9166,53,63967,0,1,57,387,84,141,73,35,162,882,3,4,4,12,2,25,0
5147,73,90842,0,0,57,774,70,118,182,187,93,1424,1,4,9,13,1,28,0
13,74,25358,0,1,57,19,0,5,0,0,8,32,2,1,0,3,6,12,0
8724,39,28567,1,0,57,11,3,22,2,2,6,46,2,2,0,3,6,13,0
9381,43,66373,1,1,57,328,9,124,12,24,109,606,7,4,2,10,3,26,0
9384,43,66373,1,1,57,328,9,124,12,24,109,606,7,4,2,10,3,26,0
3560,69,83844,0,0,57,901,31,345,75,31,191,1574,1,4,4,11,1,21,1
241,69,83844,0,0,57,901,31,345,75,31,191,1574,1,4,4,11,1,21,1
7521,69,83844,0,0,57,901,31,345,75,31,191,1574,1,4,4,11,1,21,1
9799,53,83664,1,1,57,866,21,151,28,21,86,1173,3,2,2,12,5,24,0
5123,70,27450,0,0,57,37,12,23,8,11,52,143,1,2,1,3,7,14,0
448,43,54880,1,0,57,308,85,137,102,45,118,795,2,6,2,11,5,26,0
4837,56,71322,0,1,57,753,43,226,69,10,204,1305,2,8,5,13,4,32,0
9365,45,60000,0,1,57,1048,0,217,0,0,12,1277,5,11,3,5,6,30,0
8932,52,65176,0,1,57,960,28,183,220,70,70,1531,4,9,6,6,6,31,0
7055,69,61010,0,1,57,888,0,57,0,0,76,1021,2,8,5,11,5,31,0
3537,40,31089,1,0,57,31,3,31,2,8,4,79,3,3,0,4,8,18,0
9081,33,20518,1,0,58,4,1,6,4,1,9,25,1,1,1,2,5,10,0
4988,73,34469,1,1,58,19,6,20,0,5,12,62,3,1,1,4,4,13,0
1050,69,28332,0,0,58,14,10,13,4,15,9,65,1,2,1,4,2,10,0
5610,56,33456,1,1,58,7,3,10,8,1,7,36,2,1,0,3,7,13,0
3526,53,38443,1,1,58,32,0,5,0,0,1,38,2,1,0,3,7,13,0
5136,48,65333,0,1,58,654,7,92,0,15,30,798,7,9,4,8,6,34,1
1411,69,82623,0,0,58,204,34,204,172,153,173,940,1,2,9,4,1,17,0
701,50,73691,0,1,58,707,21,250,85,43,73,1179,2,6,2,8,2,20,1
6203,74,74485,0,0,58,499,149,815,173,49,49,1734,1,6,7,12,3,29,0
7192,66,65748,0,1,58,172,73,93,95,78,34,545,2,2,4,10,1,19,0
5181,39,24367,1,0,58,2,4,2,0,11,5,24,1,1,0,2,9,13,0
9220,50,91700,0,0,58,576,172,961,125,115,19,1968,1,8,6,5,3,23,0
7734,28,79244,0,0,58,471,102,125,212,61,245,1216,1,4,10,7,1,23,1
10446,64,82017,0,0,58,184,23,446,30,23,23,729,1,5,4,7,2,19,1
5524,64,58138,0,0,58,635,88,546,172,88,88,1617,3,8,10,4,7,32,0
3830,68,59354,0,2,59,295,21,78,39,13,13,459,1,4,4,7,3,19,0
5186,66,58482,0,1,59,576,7,115,19,7,7,731,2,7,4,9,6,28,1
8514,45,29478,1,0,59,8,0,7,3,1,1,20,1,1,0,3,6,11,0
7165,49,64474,0,1,59,381,35,172,56,86,93,823,2,8,2,10,5,27,0
10236,46,31160,1,0,59,16,3,25,6,1,13,64,2,2,0,3,8,15,0
2392,49,40321,1,1,59,44,4,21,6,0,27,102,2,3,0,3,7,15,0
1920,49,40321,1,1,59,44,4,21,6,0,27,102,2,3,0,3,7,15,0
3673,50,55239,0,1,59,371,17,238,23,24,106,779,3,7,5,11,5,31,0
1453,78,57513,0,0,59,735,40,183,52,20,30,1060,2,9,3,13,6,33,0
4518,42,85693,0,1,59,386,172,183,185,132,111,1169,2,9,5,11,5,32,0
8969,44,71855,0,1,59,548,31,422,0,112,28,1141,4,5,5,11,3,28,0
387,45,7500,0,0,59,6,16,11,11,1,16,61,1,2,0,3,8,14,0
1079,50,71969,0,1,59,1000,0,76,0,0,10,1086,3,3,4,9,8,27,1
164,44,28973,0,0,59,206,0,46,3,2,12,269,2,5,1,5,8,21,0
3434,70,80872,0,0,60,483,72,567,94,12,108,1336,1,4,4,10,1,20,0
5721,65,84117,0,0,60,611,76,749,59,45,26,1566,1,7,10,6,2,26,1
8418,63,38741,1,1,60,7,10,17,8,6,13,61,2,2,0,3,7,14,0
5300,48,38961,1,0,60,19,7,19,0,1,24,70,1,2,1,2,7,13,0
10424,53,75922,0,0,60,265,138,553,224,23,92,1295,1,4,4,9,1,19,0
11171,56,56962,2,1,60,292,3,77,10,3,26,411,7,6,3,5,7,28,0
1600,56,56962,2,1,60,292,3,77,10,3,26,411,7,6,3,5,7,28,0
7851,72,70165,0,0,60,161,0,253,199,191,122,926,1,3,7,11,1,23,0
10701,48,65308,0,0,60,713,0,264,120,80,34,1211,1,7,8,12,4,32,1
891,70,29298,1,1,60,6,0,2,2,0,1,11,1,1,0,2,5,9,0
6912,54,63246,0,2,60,593,30,91,29,22,7,772,1,6,3,12,4,26,0
5967,69,33402,1,1,60,26,2,19,10,5,8,70,3,2,1,3,8,17,0
2109,31,96843,0,0,60,448,71,951,40,17,17,1544,1,6,11,10,2,30,1
6292,35,82333,0,0,60,1311,0,359,46,89,17,1822,1,4,3,10,2,20,1
8537,72,72643,0,0,60,526,80,553,123,94,53,1429,1,3,10,7,2,23,1
9576,39,32313,1,0,60,86,4,56,2,4,7,159,3,4,0,4,9,20,0
5935,65,55284,0,1,60,547,7,140,0,7,63,764,3,7,5,8,5,28,0
10264,42,15287,1,0,60,1,2,8,4,3,13,31,2,1,1,2,7,13,1
234,42,15287,1,0,60,1,2,8,4,3,13,31,2,1,1,2,7,13,1
3202,34,51563,0,0,60,1166,0,48,0,0,36,1250,1,4,4,10,8,27,1
1103,45,81929,1,0,60,1486,55,278,49,0,185,2053,2,4,4,10,6,26,1
610,68,53593,1,1,60,349,4,78,6,0,43,480,8,7,2,6,8,31,0
4480,48,60432,0,1,61,365,3,15,4,3,11,401,5,7,2,5,6,25,0
10660,64,66726,1,1,61,349,7,35,0,0,47,438,3,8,2,4,7,24,1
9353,62,62450,0,1,61,515,47,267,62,66,38,995,2,5,5,4,3,19,1
4120,46,49514,1,0,61,88,39,78,58,13,93,369,2,6,1,4,7,20,0
2836,49,43269,1,0,61,10,1,7,0,0,1,19,1,1,0,2,8,12,0
9579,62,33762,2,1,61,53,1,34,2,0,16,106,3,2,2,2,8,17,0
5841,55,60894,0,1,61,606,7,155,10,0,54,832,5,10,3,8,7,33,0
3174,62,87771,0,1,61,1492,38,287,50,57,33,1957,1,5,10,4,6,26,1
5536,62,87771,0,1,61,1492,38,287,50,57,33,1957,1,5,10,4,6,26,1
2061,66,50737,0,1,61,78,0,11,0,0,10,99,1,2,0,4,6,13,1
8477,65,26150,2,1,61,5,1,13,3,5,1,28,1,1,0,3,7,12,0
640,70,57304,0,1,61,356,80,329,138,17,106,1026,2,7,6,10,5,30,0
3828,70,71107,0,1,61,533,10,217,198,174,195,1327,2,7,6,13,4,32,0
4093,46,53253,1,1,61,216,9,57,20,9,125,436,7,4,3,5,5,24,0
8624,63,81320,0,0,61,183,33,493,59,103,57,928,1,4,3,10,2,20,0
2802,29,87000,0,0,61,196,25,607,67,17,49,961,1,4,6,7,2,20,0
368,47,40049,0,1,61,91,65,52,10,44,28,290,3,3,2,6,5,19,0
3599,51,63684,0,1,61,575,80,428,208,93,80,1464,3,8,4,8,5,28,0
3389,51,69016,0,1,61,726,53,363,123,107,161,1533,4,8,9,13,5,39,0
10710,42,7500,0,1,61,5,2,3,3,0,5,18,1,1,0,2,8,12,0
7118,64,73803,0,1,61,833,80,363,52,26,174,1528,2,9,5,6,6,28,1
4937,48,46094,1,1,62,12,2,20,3,2,5,44,1,1,0,3,7,12,0
1127,48,85844,0,0,62,938,19,843,25,95,38,1958,1,6,6,7,2,22,1
833,66,38452,1,1,62,56,0,14,0,0,2,72,3,3,0,3,7,16,0
3565,66,38452,1,1,62,56,0,14,0,0,2,72,3,3,0,3,7,16,0
6086,66,80395,0,0,62,445,25,706,80,76,48,1380,1,6,5,12,2,26,1
1763,33,87679,0,0,62,1259,172,815,97,148,33,2524,1,7,11,10,4,33,1
4697,72,35416,0,0,62,248,3,81,4,3,51,390,3,7,1,5,8,24,0
182,75,44124,0,1,62,284,0,55,0,6,52,397,4,6,2,5,8,25,0
1165,63,50729,1,1,62,239,13,143,45,4,52,496,9,6,2,7,6,30,0
5386,68,94384,0,0,62,1111,24,790,160,45,172,2302,0,5,8,5,2,20,1
6024,68,94384,0,0,62,1111,24,790,160,45,172,2302,0,5,8,5,2,20,1
2678,31,34412,1,0,62,52,12,50,4,36,55,209,3,5,0,3,9,20,0
5790,36,31158,1,0,62,25,6,16,20,0,5,72,2,2,0,3,8,15,0
236,70,34838,1,1,62,28,23,29,29,14,47,170,3,2,1,4,6,16,0
6001,42,56775,0,1,62,614,35,160,58,35,35,937,2,5,8,10,5,30,0
6250,72,54356,0,1,62,710,15,30,20,0,0,775,3,11,2,8,8,32,0
1168,43,72159,0,0,62,322,53,899,34,40,53,1401,1,4,6,10,2,23,0
10749,30,8028,0,0,62,73,18,66,7,12,2,178,15,0,1,0,19,35,0
2926,69,55951,0,1,62,1241,0,80,0,13,40,1374,3,3,6,11,8,31,1
716,72,67911,0,1,63,529,0,356,63,28,0,976,3,6,7,11,3,30,0
6544,72,67911,0,1,63,529,0,356,63,28,0,976,3,6,7,11,3,30,0
4298,48,20427,1,0,63,5,0,4,0,0,1,10,1,1,0,2,8,12,0
5823,51,32303,0,1,63,35,0,2,0,0,2,39,2,1,0,4,5,12,0
8375,53,55954,0,1,63,447,0,28,0,0,43,518,3,8,2,6,7,26,0
5723,45,49187,0,1,63,81,1,31,2,1,0,116,1,1,1,5,2,10,0
5763,49,49854,1,0,63,123,17,171,39,0,30,380,5,6,2,5,6,24,0
8727,43,63693,0,1,63,587,43,337,42,87,54,1150,3,11,6,9,6,35,0
3056,43,63693,0,1,63,587,43,337,42,87,54,1150,3,11,6,9,6,35,0
8442,36,19510,2,0,63,9,0,7,3,4,7,30,2,1,0,3,7,13,0
3712,62,52332,0,0,63,212,5,33,7,0,2,259,1,3,2,6,4,16,1
10722,48,55593,0,1,63,293,8,124,11,4,106,546,2,6,6,3,6,23,1
2406,72,54591,0,1,63,376,4,94,12,9,24,519,3,6,2,8,5,24,0
7313,72,74859,0,0,63,570,73,614,133,102,73,1565,1,6,5,11,3,26,1
2656,50,40851,1,1,63,23,1,7,0,4,24,59,1,1,1,2,7,12,0
1993,72,58607,0,1,63,867,0,86,0,0,19,972,3,2,3,9,8,25,1
4136,29,7500,1,0,63,10,17,18,8,26,40,119,4,3,2,2,9,20,0
2928,46,52614,0,1,63,789,0,142,12,9,38,990,2,2,4,8,8,24,0
2920,46,52614,0,1,63,789,0,142,12,9,38,990,2,2,4,8,8,24,0
6661,47,67445,0,1,63,757,80,217,29,80,11,1174,5,9,6,12,6,38,0
5462,47,67445,0,1,63,757,80,217,29,80,11,1174,5,9,6,12,6,38,0
10897,47,67445,0,1,63,757,80,217,29,80,11,1174,5,9,6,12,6,38,0
10542,53,36778,1,1,63,29,4,34,2,4,4,77,3,3,0,3,9,18,0
5756,38,39453,1,0,64,46,0,7,0,0,2,55,2,2,0,3,6,13,0
3570,52,42731,1,0,64,159,2,51,6,2,24,244,3,4,1,5,5,18,0
1072,56,40760,0,1,64,70,0,17,0,0,6,93,2,2,1,3,6,14,0
9606,56,69969,0,0,64,882,29,514,38,29,44,1536,1,4,2,6,3,16,1
2730,66,80317,0,0,64,536,11,387,149,91,57,1231,1,3,4,10,1,19,0
2995,64,66636,0,0,64,291,10,689,84,10,0,1084,1,3,4,9,1,18,0
8210,46,54730,0,1,64,318,3,17,4,7,56,405,5,4,1,8,4,22,0
773,50,42835,1,1,64,379,4,93,12,9,98,595,7,6,6,4,6,29,0
5272,56,53843,0,1,64,378,0,88,19,4,73,562,4,8,5,3,7,27,0
5125,61,79530,0,0,64,333,0,815,129,42,29,1348,1,4,10,11,2,28,0
4391,53,63841,0,1,64,635,15,100,20,7,131,908,1,9,3,9,6,28,0
6283,53,63841,0,1,64,635,15,100,20,7,131,908,1,9,3,9,6,28,0
3421,53,63841,0,1,64,635,15,100,20,7,131,908,1,9,3,9,6,28,0
5731,38,27100,1,0,64,12,0,13,2,0,10,37,1,1,0,3,7,12,0
7152,38,27100,1,0,64,12,0,13,2,0,10,37,1,1,0,3,7,12,0
3919,45,72309,0,0,64,960,0,883,50,38,0,1931,1,5,6,8,3,23,1
6097,62,50664,1,1,64,313,8,104,6,4,126,561,9,8,1,6,9,33,0
5150,42,20194,1,0,64,0,4,7,11,10,15,47,2,2,0,3,6,13,0
10479,46,76618,0,0,64,749,40,294,121,160,147,1511,1,3,2,5,1,12,0
5966,47,45207,1,1,64,203,0,10,0,0,2,215,5,3,1,6,6,21,1
3439,49,56721,1,1,64,157,6,39,6,13,75,296,5,4,1,5,6,21,0
6609,55,27038,0,0,64,1,26,25,17,23,15,107,1,3,0,3,9,16,0
5393,44,23763,1,0,64,22,0,6,6,2,6,42,1,1,0,3,7,12,0
9014,46,37085,1,1,65,39,1,16,2,0,3,61,4,3,0,3,8,18,0
4050,55,49605,0,0,65,42,16,29,12,20,8,127,1,2,1,4,3,11,0
6862,50,1730,0,0,65,1,1,3,1,1,1,8,15,0,0,0,20,35,0
8315,26,34824,0,0,65,4,2,11,2,0,4,23,1,1,0,2,6,10,0
5184,26,34824,0,0,65,4,2,11,2,0,4,23,1,1,0,2,6,10,0
3643,47,63206,0,0,65,750,8,125,11,8,26,928,1,4,3,6,2,16,1
2589,49,26759,1,0,65,25,3,16,8,5,2,59,2,2,1,3,6,14,0
4887,45,55412,1,1,65,10,5,28,11,1,8,63,1,2,0,3,5,11,0
10104,47,33590,2,1,65,4,0,2,0,0,2,8,1,1,0,2,7,11,0
3254,50,70886,1,0,65,407,70,239,103,88,53,960,1,5,4,4,2,16,0
2004,52,72679,0,1,65,619,54,260,127,54,54,1168,1,4,7,5,1,18,0
6142,78,65073,0,0,65,629,17,177,69,0,8,900,1,5,3,5,2,16,0
8553,56,44300,1,1,65,30,0,9,0,0,3,42,2,1,0,3,6,12,0
9805,68,56129,0,1,65,320,48,133,39,72,48,660,4,6,2,10,4,26,0
849,68,56129,0,1,65,320,48,133,39,72,48,660,4,6,2,10,4,26,0
1606,50,38590,1,0,65,3,1,8,4,3,3,22,1,1,0,2,8,12,0
125,63,53083,1,1,65,215,7,33,3,0,13,271,6,5,1,5,7,24,1
9305,45,79689,0,0,65,311,26,640,180,37,121,1315,1,4,9,13,2,29,0
4706,55,34704,0,1,65,29,0,5,0,1,5,40,1,1,0,3,5,10,0
4437,59,65316,1,1,65,112,6,92,3,9,38,260,2,3,2,5,4,16,0
3081,43,41014,1,0,65,7,2,6,2,0,3,20,1,1,0,2,7,11,0
3536,61,19740,0,1,65,7,11,3,10,4,20,55,2,1,1,3,5,12,0
8686,42,23724,1,0,65,5,23,15,0,18,14,75,2,2,0,3,8,15,0
9707,52,55212,0,1,65,1103,0,45,0,0,34,1182,3,4,2,11,8,28,1
10872,52,55212,0,1,65,1103,0,45,0,0,34,1182,3,4,2,11,8,28,1
9058,66,79800,0,0,65,1060,21,530,32,0,224,1867,1,5,11,5,3,25,1
4640,54,70647,0,1,65,561,85,171,25,123,114,1079,2,4,7,13,2,28,0
2525,47,38410,0,0,65,153,64,123,116,64,14,534,2,5,2,9,6,24,0
9503,41,28071,0,0,65,39,33,130,41,26,44,313,2,5,1,5,8,21,0
10704,52,54803,0,1,65,404,0,92,28,27,142,693,2,6,2,9,4,23,0
2669,28,74293,0,0,66,375,152,335,93,91,81,1127,1,5,4,6,2,18,0
10037,28,74293,0,0,66,375,152,335,93,91,81,1127,1,5,4,6,2,18,0
5680,37,35684,1,0,66,10,4,7,0,6,3,30,1,1,0,3,6,11,0
3726,35,34320,1,0,66,4,1,9,3,0,0,17,1,1,0,2,8,12,0
4548,40,41967,1,1,66,23,4,10,0,2,15,54,1,1,0,3,4,9,0
4599,45,49681,0,2,66,411,0,26,0,0,21,458,6,7,1,7,7,28,0
879,45,49681,0,2,66,411,0,26,0,0,21,458,6,7,1,7,7,28,0
7409,51,53187,1,0,66,211,2,30,7,7,10,267,2,4,1,6,5,18,0
1964,70,86610,0,0,66,446,107,768,33,196,53,1603,1,5,6,6,2,20,0
0,36,70951,0,0,66,239,10,554,254,87,54,1198,1,3,4,9,1,18,0
4860,51,24206,1,0,66,7,2,8,3,2,3,25,1,1,0,3,6,11,0
425,36,55357,2,0,66,374,64,116,84,25,64,727,3,6,2,11,5,27,0
9500,62,58113,0,1,66,221,104,169,102,78,84,758,3,9,2,8,7,29,0
3074,37,70643,0,0,66,1218,107,304,23,143,33,1828,1,5,8,4,6,24,0
5140,36,64355,1,0,66,1047,0,140,67,38,153,1445,2,4,3,12,8,29,0
2611,62,82576,0,0,66,1206,55,445,168,18,18,1910,1,2,4,12,1,20,1
916,49,41644,1,1,67,20,3,4,2,0,2,31,2,1,0,3,3,9,0
10413,37,72570,0,0,67,274,83,216,151,141,224,1089,1,4,6,12,1,24,0
3696,56,30630,1,1,67,27,1,12,2,0,10,52,2,2,0,3,7,14,0
304,40,22944,1,0,67,19,3,19,4,5,26,76,3,3,0,3,7,16,0
5113,50,86979,0,0,67,584,100,835,65,83,35,1702,1,5,5,5,2,18,1
4597,51,82072,0,0,67,889,55,685,168,92,129,2018,1,3,2,13,1,20,0
675,48,52034,1,1,67,146,0,93,7,13,73,332,5,4,2,5,7,23,0
4483,28,72354,0,0,67,315,26,473,220,12,182,1228,1,2,10,6,1,20,0
1502,38,28427,1,0,67,18,3,19,3,3,6,52,2,2,0,3,8,15,0
736,38,28427,1,0,67,18,3,19,3,3,6,52,2,2,0,3,8,15,0
4487,52,39858,1,0,67,15,20,25,2,7,26,95,1,2,0,4,6,13,0
3412,70,67381,0,1,67,815,8,53,11,0,70,957,4,2,2,9,7,24,1
1744,56,23529,0,1,67,9,7,13,3,2,20,54,1,1,1,2,6,11,0
5837,54,51479,1,1,67,247,8,160,6,8,65,494,7,6,3,6,7,29,0
3422,46,76068,0,1,67,1115,12,128,33,12,76,1376,1,2,3,4,6,16,1
7462,67,22507,0,0,67,68,0,226,51,157,68,570,3,10,2,4,9,28,0
10702,37,52413,1,0,67,185,8,133,56,56,12,450,2,7,1,7,7,24,0
2115,64,50116,1,1,68,54,0,10,0,0,2,66,2,1,0,4,5,12,1
4138,59,76624,0,1,68,411,106,147,54,115,66,899,1,5,10,7,1,24,1
11091,68,34587,1,1,68,7,2,9,2,0,2,22,2,1,0,3,4,10,0
7712,75,62159,0,0,68,182,17,259,77,70,29,634,1,6,2,10,4,23,0
3535,56,66294,0,0,68,251,108,334,65,92,117,967,1,4,3,5,2,15,0
5899,71,5648,1,1,68,28,0,6,1,1,13,49,1,1,0,0,20,22,1
8749,37,37235,1,0,68,20,2,9,4,6,20,61,1,1,1,2,4,9,0
10955,57,85620,0,0,68,416,46,925,60,107,46,1600,1,3,6,4,1,15,0
9491,37,23976,1,0,68,14,1,21,2,3,25,66,3,3,1,3,7,17,0
5286,34,41020,0,0,68,112,1,54,7,7,36,217,1,3,2,4,3,13,0
3409,37,36108,1,0,68,141,8,129,3,11,47,339,3,7,1,4,9,24,1
2544,70,57530,0,1,68,50,1,27,6,7,1,92,1,1,1,4,1,8,0
2118,57,62905,0,1,68,166,75,96,119,107,59,622,3,7,2,8,4,24,0
9370,76,65846,0,0,68,562,81,276,80,40,81,1120,1,6,3,6,4,20,0
4864,44,34380,1,0,68,72,7,58,13,1,24,175,4,4,1,3,8,20,0
405,57,41638,0,1,68,315,0,31,4,0,91,441,4,5,5,3,8,25,1
10513,29,63207,0,0,68,438,169,565,91,169,70,1502,1,2,3,6,7,19,1
5138,71,28320,0,1,68,19,1,14,3,2,4,43,1,1,0,3,8,13,0
8387,64,43140,0,1,68,134,8,76,6,0,11,235,1,4,1,5,6,17,0
378,50,52531,0,0,68,283,112,151,51,72,125,794,2,7,2,10,6,27,0
5846,44,40246,1,0,68,2,1,6,2,1,1,13,1,1,0,2,6,10,0
8870,37,35196,1,0,68,75,12,141,43,39,187,497,6,6,1,5,8,26,0
10340,37,35196,1,0,68,75,12,141,43,39,187,497,6,6,1,5,8,26,0
7290,36,70596,0,0,68,347,44,534,17,0,26,968,1,3,5,12,2,23,0
8895,36,70596,0,0,68,347,44,534,17,0,26,968,1,3,5,12,2,23,0
3635,59,52597,0,1,69,492,0,37,7,0,42,578,3,6,3,8,5,25,0
11178,49,42394,1,0,69,15,2,10,0,1,4,32,1,1,0,3,7,12,0
2410,52,81657,0,0,69,364,40,425,158,60,50,1097,1,3,4,8,1,17,0
3281,61,49154,1,1,69,206,10,67,30,27,71,411,6,4,1,8,6,25,0
9905,69,34074,1,1,69,135,1,41,10,1,67,255,5,3,3,3,6,20,1
2565,66,70638,0,0,69,1016,12,215,16,12,63,1334,1,4,5,10,3,23,1
7912,43,38136,1,0,69,8,15,27,0,20,33,103,2,3,1,2,8,16,1
7072,48,67432,0,1,69,432,79,341,177,136,170,1335,2,8,5,4,4,23,0
1409,70,40689,0,1,69,270,3,27,39,6,99,444,7,7,1,5,8,28,0
5314,70,40689,0,1,69,270,3,27,39,6,99,444,7,7,1,5,8,28,0
7215,38,101970,0,0,69,722,27,102,44,72,168,1135,0,6,8,13,2,29,1
8858,49,44325,0,1,69,516,0,21,0,0,5,542,4,8,2,7,8,29,1
895,73,61467,0,2,69,410,16,114,0,5,49,594,3,5,2,10,5,25,0
10313,46,48178,1,1,69,159,4,45,6,2,38,254,6,5,1,4,8,24,0
642,41,16005,1,0,69,1,3,2,20,30,47,103,3,2,1,2,8,16,0
8504,48,79593,0,0,70,350,60,568,110,133,145,1366,1,5,6,7,2,21,1
1020,48,79593,0,0,70,350,60,568,110,133,145,1366,1,5,6,7,2,21,1
3717,62,61180,0,1,70,403,24,29,6,24,218,704,2,5,5,6,3,21,1
7646,32,64449,1,0,70,218,63,282,137,35,70,805,4,5,3,12,4,28,0
5796,58,77437,0,0,70,560,21,442,29,44,29,1125,1,4,5,13,1,24,1
8625,45,17649,1,0,70,15,1,23,0,5,1,45,3,3,0,3,8,17,0
5407,67,53103,0,1,70,729,17,133,11,0,195,1085,5,10,6,7,7,35,1
4356,50,71819,0,1,70,1224,28,140,0,14,168,1574,3,3,3,5,6,20,1
2886,50,74290,0,1,70,1121,0,72,0,12,12,1217,4,10,8,10,6,38,1
10057,70,72282,0,0,70,503,27,419,90,139,153,1331,1,5,7,9,7,29,0
10741,70,47352,0,1,70,172,12,112,8,0,15,319,4,6,1,5,7,23,0
5491,70,47352,0,1,70,172,12,112,8,0,15,319,4,6,1,5,7,23,0
4442,60,46524,0,1,70,31,19,35,26,14,52,177,2,1,1,5,3,12,0
3972,45,50200,1,1,70,266,6,51,8,6,64,401,6,7,1,5,8,27,0
2431,31,18222,0,0,70,12,4,19,12,6,14,67,1,2,0,3,8,14,0
7899,69,77610,0,1,70,1245,33,332,21,33,16,1680,2,4,7,4,7,24,0
9703,51,38097,1,1,70,77,2,35,0,1,69,184,4,3,2,2,7,18,1
6927,53,44377,1,1,70,224,0,30,0,0,10,264,8,5,1,5,8,27,0
7005,40,58684,0,0,71,479,35,179,28,7,85,813,1,5,3,12,2,23,1
246,56,66480,1,1,71,199,9,57,20,21,6,312,7,4,1,7,4,23,0
4796,69,49638,0,1,71,18,10,3,3,5,0,39,1,1,0,3,2,7,0
4725,71,50616,0,1,71,30,2,25,0,1,9,67,1,1,1,4,2,9,0
3286,54,26642,1,0,71,13,2,15,2,2,8,42,2,2,0,3,6,13,0
10680,35,33235,1,0,71,45,0,16,2,1,6,70,1,3,0,3,7,14,0
4297,52,23228,1,0,71,13,2,18,6,1,0,40,2,2,0,3,8,15,0
7327,62,36732,1,1,71,21,5,3,10,1,7,47,3,1,1,4,2,11,0
1553,75,82657,0,0,71,966,168,672,246,105,126,2283,1,7,5,10,4,27,1
1665,57,64140,0,2,71,1459,0,61,0,15,215,1750,5,2,5,6,5,23,1
10640,47,44392,1,1,71,87,5,71,7,12,29,211,5,4,1,4,7,21,0
7620,31,16185,1,0,71,5,11,16,21,8,45,106,2,2,2,2,8,16,0
7761,43,38702,1,0,71,13,11,24,13,8,40,109,2,3,0,4,6,15,0
5062,58,54072,1,1,71,35,0,4,0,0,0,39,1,2,0,2,8,13,0
6349,34,61787,0,0,71,621,73,414,78,48,85,1319,1,8,4,6,5,24,0
3386,29,34935,0,0,71,34,4,66,3,10,20,137,1,2,1,4,7,15,0
8175,29,34935,0,0,71,34,4,66,3,10,20,137,1,2,1,4,7,15,0
6245,71,59292,0,1,71,378,14,68,19,14,14,507,2,3,5,8,3,21,0
8780,71,59292,0,1,71,378,14,68,19,14,14,507,2,3,5,8,3,21,0
2276,66,57959,0,1,71,430,16,322,43,24,33,868,5,4,7,11,3,30,0
1172,38,92491,0,0,71,979,44,935,29,25,22,2034,1,7,5,12,3,28,1
3225,37,42207,1,0,71,116,11,72,3,17,46,265,4,4,1,5,6,20,1
8629,65,46984,1,1,71,19,1,10,2,1,8,41,1,1,0,3,5,10,0
798,34,23442,1,0,71,2,0,6,8,6,5,27,1,1,0,3,7,12,0
269,58,46757,0,1,71,777,30,163,0,51,122,1143,6,4,4,7,9,30,0
8213,41,14515,1,0,71,6,4,9,6,36,35,96,4,2,2,3,7,18,0
10245,35,80910,0,0,71,160,80,369,67,39,41,756,1,3,3,8,1,16,0
2447,42,30545,1,0,71,4,12,15,19,7,12,69,2,2,0,3,7,14,0
9817,51,44802,0,0,71,853,10,143,13,10,20,1049,2,9,4,12,8,35,0
1371,45,79941,0,0,72,123,164,266,227,30,174,984,1,2,4,9,1,17,0
8093,52,79734,0,0,72,572,8,232,23,62,17,914,1,4,3,6,1,15,1
713,44,50353,0,0,72,141,15,153,67,31,35,442,1,4,4,6,3,18,0
11051,65,77376,1,1,72,492,19,110,16,12,12,661,4,6,3,10,4,27,0
5545,49,78075,0,0,72,572,8,259,34,35,80,988,1,3,5,5,1,15,0
5283,45,42473,1,1,72,93,1,21,0,4,25,144,3,2,1,4,5,15,0
5010,33,25008,1,0,72,2,8,8,6,1,9,34,2,1,0,3,8,14,0
7495,73,56223,0,1,72,77,28,31,16,0,4,156,2,2,1,5,4,14,0
4368,41,47850,1,0,72,42,7,43,20,12,10,134,1,3,0,4,6,14,0
6303,35,91820,0,0,72,410,73,747,76,161,30,1497,0,5,5,12,1,23,0
1030,56,40637,1,1,72,22,0,13,0,0,3,38,2,1,0,3,7,13,0
10364,62,23295,0,0,72,0,0,1,2,12,5,20,1,1,0,2,8,12,0
6945,69,84574,0,0,72,387,20,713,38,54,163,1375,1,9,11,11,5,37,0
8562,52,54165,0,0,72,127,4,73,15,6,11,236,1,2,1,7,2,13,0
2918,40,28510,1,1,72,44,5,19,0,4,19,91,3,2,0,4,5,14,0
9167,65,67131,0,1,72,465,71,250,93,35,62,976,3,9,2,12,6,32,0
4743,52,56242,0,1,72,689,8,167,11,8,88,971,5,8,4,11,6,34,0
10742,38,86580,0,0,72,532,21,127,26,20,20,746,0,4,2,5,1,12,1
10965,66,76005,0,0,72,983,20,389,240,50,40,1722,1,3,5,13,6,28,1
7129,59,54693,0,1,72,686,17,142,23,26,35,929,8,6,4,13,6,37,0
3732,66,52750,0,1,72,393,0,239,90,69,69,860,6,5,7,9,4,31,0
7124,53,36997,1,1,72,43,4,12,8,0,27,94,5,2,1,4,5,17,0
10686,56,34230,1,1,72,15,0,4,0,0,2,21,1,1,0,2,7,11,0
7247,61,47916,0,1,72,505,0,26,0,0,75,606,5,7,4,6,6,28,1
1513,42,60839,1,1,72,600,21,128,223,150,128,1250,13,2,2,12,8,37,0
460,49,79930,0,0,72,792,86,740,67,51,17,1753,1,3,5,8,2,19,0
6653,51,55158,1,1,72,293,0,87,4,11,23,418,4,7,2,5,7,25,0
9400,63,85485,0,0,73,630,26,611,44,18,54,1383,1,6,6,6,2,21,0
7106,78,75865,0,0,73,483,0,591,156,0,12,1242,1,3,5,10,1,20,0
4252,56,44375,0,1,73,213,5,28,7,7,41,301,1,4,1,6,5,17,0
9240,50,60504,0,1,73,458,0,24,6,4,34,526,2,6,2,8,6,24,0
10770,62,65492,0,0,73,247,161,295,210,85,47,1045,2,4,7,13,2,28,0
176,41,67506,0,1,73,90,38,67,33,36,67,331,1,4,1,6,3,15,0
6870,62,68805,0,1,73,182,2,49,17,13,20,283,1,3,1,7,2,14,0
143,51,61209,0,0,73,466,0,224,119,49,99,957,1,5,3,4,2,15,0
6445,54,66825,0,0,73,243,101,405,29,40,40,858,1,4,5,6,2,18,0
4278,38,87188,0,0,73,910,111,724,49,74,55,1923,1,10,2,6,3,22,0
6906,68,84953,0,0,73,167,48,602,63,72,72,1024,1,3,10,4,2,20,1
4637,67,74637,0,0,73,960,64,464,146,0,16,1650,1,6,9,9,3,28,1
8690,59,86111,0,0,73,399,28,756,36,40,126,1385,1,5,7,10,2,25,0
1173,74,77632,0,0,73,1200,105,758,0,42,147,2252,1,4,2,6,2,15,1
1928,48,31814,1,0,73,35,3,20,4,1,20,83,2,2,0,3,9,16,1
9029,49,70116,0,0,73,707,44,603,95,58,29,1536,1,2,8,12,1,24,0
10299,52,48240,0,0,73,389,91,248,64,49,41,882,3,6,3,13,5,30,0
9246,36,40101,1,0,73,171,3,129,26,24,62,415,4,6,1,6,7,24,0
4943,68,70503,0,0,73,1379,33,216,0,33,66,1727,1,2,4,9,6,22,1
4122,46,79205,0,0,73,504,23,117,179,28,44,895,1,6,5,4,4,20,1
2853,41,51766,1,0,74,60,51,87,6,20,51,275,2,4,2,4,5,17,0
902,41,62994,1,0,74,224,12,48,4,12,12,312,1,6,2,4,6,19,0
1672,47,65640,0,1,74,204,7,149,20,15,66,461,1,5,1,8,2,17,0
7254,52,38361,1,0,74,39,0,56,20,8,14,137,3,3,1,3,7,17,0
8775,52,38361,1,0,74,39,0,56,20,8,14,137,3,3,1,3,7,17,0
9543,36,19986,1,0,74,3,6,5,0,2,6,22,1,0,0,3,7,11,0
7093,36,19986,1,0,74,3,6,5,0,2,6,22,1,0,0,3,7,11,0
2894,36,72903,0,0,74,1067,138,750,0,19,39,2013,1,7,5,8,4,25,1
5956,73,45072,1,2,74,144,2,99,7,2,30,284,5,6,1,4,8,24,0
1921,54,59062,2,1,74,46,1,12,3,0,9,71,2,2,0,3,4,11,0
5057,60,61794,0,1,74,264,47,188,54,47,11,611,2,4,4,10,2,22,0
10260,56,45143,0,1,74,202,5,74,11,5,14,311,3,6,1,5,7,22,0
2262,56,45143,0,1,74,202,5,74,11,5,14,311,3,6,1,5,7,22,0
7930,52,26877,0,0,74,101,13,76,20,18,40,268,2,3,1,6,6,18,0
1461,56,36921,1,1,74,17,1,12,3,1,4,38,2,2,0,3,7,14,0
7514,65,54342,1,1,74,84,10,34,11,10,28,177,4,3,1,4,6,18,0
6461,52,62772,0,1,74,581,49,157,43,8,108,946,1,5,6,11,2,25,1
257,62,75032,0,1,74,952,12,180,47,12,12,1215,2,5,4,9,3,23,0
9460,58,22419,0,0,74,30,3,47,19,21,42,162,1,3,2,2,8,16,0
3855,58,22419,0,0,74,30,3,47,19,21,42,162,1,3,2,2,8,16,0
367,43,36550,1,0,74,47,90,94,123,103,120,577,5,9,1,5,9,29,0
9265,68,75027,0,1,74,925,64,179,133,12,77,1390,2,9,4,6,5,26,0
1990,47,63159,0,0,74,965,34,586,89,86,37,1797,1,3,5,8,3,20,1
3594,48,54108,1,1,74,539,6,91,8,6,97,747,13,8,2,9,8,40,0
9292,69,81795,0,0,74,324,132,693,27,118,88,1382,1,4,11,7,2,25,0
6218,56,59594,0,1,74,457,4,29,0,0,9,499,1,8,1,7,7,24,1
6528,39,18492,1,0,75,2,2,2,2,1,1,10,1,1,0,2,8,12,0
10164,63,94472,0,1,75,1017,33,417,108,100,16,1691,1,5,5,5,5,21,1
9937,42,70337,0,0,75,187,81,149,25,43,91,576,1,2,2,12,1,18,0
274,48,34853,1,1,75,9,3,15,2,3,2,34,2,2,0,3,6,13,0
11010,37,16269,1,0,75,19,3,18,3,1,0,44,3,3,0,3,8,17,0
6969,39,50272,1,0,75,99,13,66,43,8,4,233,3,4,1,5,7,20,0
10735,50,22804,1,0,75,14,1,7,2,1,1,26,1,2,0,2,9,14,0
5068,50,22804,1,0,75,14,1,7,2,1,1,26,1,2,0,2,9,14,0
9974,47,30631,1,0,75,15,6,20,4,5,20,70,1,3,1,2,7,14,0
7053,55,78420,0,0,75,604,28,674,91,28,28,1453,1,3,10,8,1,23,0
3179,41,81741,0,0,75,249,153,940,58,134,38,1572,0,6,6,7,2,21,0
8082,50,25721,1,0,75,1,3,6,3,6,15,34,1,1,1,2,7,12,0
1362,49,31907,0,0,75,33,87,64,175,16,74,449,1,6,1,6,7,21,0
6768,59,37859,1,2,75,22,1,8,2,1,2,36,2,1,0,3,8,14,0
2375,49,30261,1,2,75,8,0,5,0,3,6,22,1,0,0,3,8,12,0
6856,42,21645,1,0,75,14,0,23,4,5,19,65,3,3,0,3,9,18,0
4066,43,21282,1,0,76,1,5,8,4,8,20,46,2,2,1,2,6,13,0
4333,67,32144,1,1,76,41,0,10,0,0,3,54,4,2,1,3,7,17,1
2948,67,62637,0,1,76,104,12,48,4,12,5,185,1,2,2,5,2,12,0
4927,50,16626,2,0,76,8,3,22,21,1,13,68,3,3,0,3,9,18,0
7426,50,54690,1,1,76,111,16,37,7,9,18,198,3,3,1,5,3,15,0
8360,50,54690,1,1,76,111,16,37,7,9,18,198,3,3,1,5,3,15,0
4058,66,61284,0,0,76,618,15,106,20,7,45,811,1,11,2,8,6,28,1
10755,45,23718,1,0,76,6,3,14,15,7,36,81,3,3,1,2,7,16,0
8414,59,33419,0,1,76,56,0,12,0,0,18,86,2,2,0,4,7,15,0
6810,38,82025,0,0,76,267,98,606,48,70,98,1187,1,3,2,6,1,13,1
3839,63,15056,1,1,76,6,12,3,21,6,40,88,5,2,2,3,5,17,0
3483,63,48192,0,0,76,1039,43,204,153,58,29,1526,3,2,8,12,8,33,1
238,54,67309,1,1,76,515,47,181,149,95,95,1082,15,9,6,9,7,46,0
591,64,66033,0,1,76,293,35,179,46,59,65,677,2,8,3,7,7,27,0
5063,44,28769,1,0,76,41,5,129,10,3,3,191,3,4,1,4,9,21,0
4303,64,6835,0,1,76,107,2,12,2,2,12,137,0,0,0,1,20,21,0
2258,35,32880,1,0,76,8,4,15,7,6,2,42,1,1,0,3,8,13,0
7301,39,23616,1,0,76,4,22,11,3,7,32,79,2,3,0,3,8,16,0
11121,40,19419,1,0,76,2,14,28,16,3,7,70,4,4,0,3,9,20,0
5287,48,34961,1,0,77,45,2,26,4,1,1,79,3,3,1,3,7,17,0
6457,45,64892,0,1,77,527,24,230,32,24,65,902,2,6,4,12,4,28,0
3559,33,16248,1,0,77,12,11,10,3,12,9,57,3,2,1,3,6,15,0
5577,38,43776,1,0,77,8,0,9,2,1,3,23,1,1,0,2,6,10,0
641,54,52074,0,1,77,59,0,12,0,0,48,119,1,2,2,2,4,11,1
954,61,22123,0,0,77,3,3,24,34,7,31,102,1,2,1,3,5,12,0
1834,43,35544,1,0,77,30,5,23,4,1,4,67,1,2,0,3,7,13,0
8789,32,59060,1,0,77,35,40,111,36,40,12,274,3,3,1,7,4,18,0
10584,45,65665,0,1,77,225,162,387,106,36,29,945,1,5,10,8,3,27,0
2337,50,29819,1,0,77,9,1,24,2,1,2,39,3,3,0,3,6,15,0
6071,32,81217,0,0,77,493,70,324,146,40,84,1157,1,3,7,11,1,23,0
295,32,81217,0,0,77,493,70,324,146,40,84,1157,1,3,7,11,1,23,0
10203,31,26095,1,0,77,11,7,9,3,1,11,42,1,1,0,3,7,12,0
3968,51,65706,0,0,77,918,10,129,13,0,129,1199,1,11,3,12,7,34,1
4037,45,31859,1,0,77,3,1,3,8,0,5,20,1,1,0,2,7,11,0
6932,80,93027,0,0,77,1285,42,716,55,0,21,2119,0,7,10,5,2,24,1
10159,51,58710,0,1,77,440,81,368,0,122,174,1185,6,11,5,9,6,37,0
1177,55,49618,1,1,77,80,3,26,4,2,14,129,4,3,1,3,7,18,0
9426,57,58308,0,1,77,691,0,69,10,0,130,900,4,2,6,3,8,23,0
10637,57,40800,1,2,77,24,0,27,8,30,10,99,2,3,0,3,7,15,0
10826,62,18690,0,0,77,6,1,7,23,4,19,60,1,1,1,2,8,13,0
4086,62,18690,0,0,77,6,1,7,23,4,19,60,1,1,1,2,8,13,0
10304,62,18690,0,0,77,6,1,7,23,4,19,60,1,1,1,2,8,13,0
7998,63,28087,1,1,77,53,8,17,13,0,21,112,3,2,2,2,7,16,0
10992,54,75702,1,1,77,650,28,353,45,42,30,1148,5,4,6,11,8,34,0
6383,50,32892,1,0,78,26,0,15,2,1,2,46,2,3,0,3,8,16,0
10536,50,32892,1,0,78,26,0,15,2,1,2,46,2,3,0,3,8,16,0
6036,62,89120,0,0,78,1168,92,408,72,129,55,1924,1,5,6,7,1,20,1
11092,60,27116,1,1,78,12,1,21,2,2,3,41,2,2,0,3,7,14,0
538,32,46107,1,0,78,31,9,27,16,9,33,125,1,1,1,4,3,10,0
10022,48,54466,1,1,78,12,0,4,0,0,0,16,1,1,0,2,5,9,0
10157,56,59686,0,1,78,89,15,89,34,42,5,274,1,4,1,6,4,16,0
3503,71,82460,0,0,78,255,47,573,52,32,15,974,1,5,3,6,1,16,0
146,61,76045,0,0,78,760,53,400,17,93,0,1323,1,4,5,11,2,23,1
5538,46,83829,0,0,78,897,161,430,186,161,27,1862,0,4,7,6,1,18,1
3910,46,83829,0,0,78,897,161,430,186,161,27,1862,0,4,7,6,1,18,1
4227,53,32889,1,1,78,28,0,13,4,2,8,55,3,2,1,3,5,14,0
6634,42,33462,1,0,78,22,3,18,0,0,11,54,1,2,0,3,7,13,0
8916,46,36627,2,0,78,9,1,5,0,0,1,16,1,0,0,3,5,9,0
6460,39,28718,1,0,78,12,4,6,11,8,16,57,2,2,0,3,8,15,0
5883,49,77981,1,0,78,138,120,204,16,126,60,664,3,7,4,7,5,26,0
10091,65,60230,0,1,78,520,20,367,39,81,40,1067,2,6,3,6,5,22,0
697,52,74918,0,0,78,972,59,913,25,19,59,2047,1,5,9,6,3,24,1
2607,68,40464,0,1,78,424,17,118,7,23,41,630,6,8,2,8,8,32,0
8427,65,64857,0,0,78,556,14,717,210,0,43,1540,1,7,5,10,4,27,0
217,65,64857,0,0,78,556,14,717,210,0,43,1540,1,7,5,10,4,27,0
6202,61,63381,0,1,78,571,50,142,33,50,159,1005,4,4,5,13,2,28,0
3856,61,63381,0,1,78,571,50,142,33,50,159,1005,4,4,5,13,2,28,0
10648,39,66664,0,0,78,398,96,447,220,96,32,1289,1,5,7,6,3,22,0
5120,39,66664,0,0,78,398,96,447,220,96,32,1289,1,5,7,6,3,22,0
6749,55,86358,1,1,78,957,47,494,82,47,95,1722,4,5,3,6,8,26,0
1584,44,41443,1,0,79,171,7,171,25,19,89,482,6,8,1,5,8,28,0
9559,60,57072,0,1,79,944,0,60,0,0,30,1034,2,7,5,13,5,32,1
771,54,54178,0,1,79,135,9,39,4,0,7,194,1,2,2,5,2,12,0
5237,71,48767,1,2,79,28,1,21,3,0,10,63,3,2,1,3,5,14,0
2461,66,51124,1,1,79,26,1,11,0,1,4,43,2,1,0,3,3,9,0
5474,51,43020,1,0,79,45,7,99,4,25,43,223,3,4,1,4,6,18,0
2895,58,49980,0,1,79,104,1,54,13,9,14,195,2,3,1,5,5,16,0
7972,66,72906,0,0,79,400,32,519,71,75,54,1151,1,3,4,9,1,18,0
10067,45,25176,1,1,79,4,0,4,0,0,5,13,1,1,0,2,7,11,0
500,44,96876,0,0,79,908,43,735,40,194,21,1941,1,7,7,9,2,26,1
922,42,31086,1,1,79,16,2,11,3,0,16,48,2,1,1,2,8,14,1
2861,38,24072,1,0,79,9,1,6,3,0,4,23,1,1,0,2,8,12,0
375,67,76773,0,0,79,516,56,449,86,33,16,1156,1,2,2,11,1,17,0
10936,56,72190,0,0,79,597,166,597,172,166,249,1947,1,5,6,4,3,19,0
10314,73,83837,0,0,79,847,66,119,86,89,111,1318,1,9,10,5,4,29,1
4240,43,17345,1,0,79,4,9,16,17,0,12,58,2,2,1,2,8,15,0
2674,63,75154,0,1,79,543,10,205,160,143,82,1143,1,6,3,6,3,19,0
2563,60,28249,0,0,80,1,9,7,2,14,10,43,1,2,0,3,6,12,0
8312,60,28249,0,0,80,1,9,7,2,14,10,43,1,2,0,3,6,12,0
6999,41,69661,0,0,80,656,16,106,32,16,8,834,1,7,3,12,3,26,0
7574,42,27922,1,0,80,11,0,13,2,4,11,41,1,2,0,3,4,10,0
5223,55,45903,0,1,80,33,8,10,2,10,3,66,2,2,1,3,4,12,0
2952,44,36273,1,0,80,29,3,30,3,2,9,76,2,3,0,3,6,14,0
7683,53,70777,0,1,80,554,35,113,0,7,78,787,3,5,3,12,3,26,0
9481,45,17148,1,0,80,9,9,11,13,10,16,68,4,3,1,3,8,19,0
9907,52,66476,0,1,80,742,28,152,25,9,57,1013,2,6,8,10,4,30,0
5454,42,45057,1,0,80,37,0,7,3,0,3,50,1,2,0,3,5,11,0
3798,53,41120,1,1,80,24,2,23,0,8,24,81,3,2,1,3,6,15,0
4259,35,19485,2,0,80,6,0,4,0,0,0,10,1,1,0,2,7,11,0
2549,38,21840,1,0,80,17,0,9,0,0,1,27,1,1,0,3,9,14,0
6437,36,41473,1,0,80,21,8,20,15,3,9,76,1,2,0,3,7,13,0
2488,65,31395,1,1,80,23,1,25,0,8,7,64,4,2,1,3,6,16,0
3945,74,68117,0,1,80,618,44,215,0,17,36,930,2,11,8,4,6,31,1
702,46,47682,0,1,80,162,61,83,97,57,61,521,4,4,3,8,5,24,0
9010,49,83151,0,0,80,968,147,842,137,42,210,2346,1,5,7,10,2,25,1
9710,52,58086,0,1,80,708,7,62,0,0,15,792,2,11,3,7,8,31,0
1509,63,84460,0,0,80,152,27,103,106,54,81,523,0,9,9,4,5,27,1
9120,59,66565,0,1,80,747,10,161,65,40,42,1065,4,4,2,9,8,27,0
5252,52,23910,1,0,80,16,12,18,7,1,13,67,1,2,0,3,7,13,0
5959,53,35893,1,1,80,158,0,23,0,0,18,199,6,3,1,5,8,23,0
7441,48,71128,1,0,80,958,159,447,20,0,31,1615,3,2,10,12,7,34,0
4271,32,38683,1,0,80,46,35,69,84,41,66,341,6,4,1,6,7,24,0
4095,50,37150,1,0,80,167,37,64,49,34,116,467,8,4,3,6,7,28,0
8852,45,61064,0,1,80,387,126,342,0,45,180,1080,5,8,4,11,6,34,0
7698,45,51650,0,1,81,152,3,22,2,5,7,191,1,4,1,4,5,15,0
4174,65,55249,0,1,81,97,1,19,2,0,11,130,1,2,1,4,3,11,0
3182,48,46854,1,1,81,96,1,79,7,1,79,263,6,5,1,3,8,23,1
193,25,14421,0,0,81,0,0,2,3,3,8,16,1,1,0,2,5,9,1
5229,52,54132,0,1,81,30,1,8,0,0,3,42,1,1,0,3,7,12,0
5555,46,153924,0,0,81,1,1,1,1,1,1,6,0,0,0,0,0,0,0
7732,43,64813,1,0,81,293,0,124,179,97,52,745,1,7,2,10,5,25,0
310,51,61872,0,1,81,330,5,159,36,27,16,573,4,4,4,9,4,25,0
6261,42,58025,0,1,81,270,31,88,11,48,22,470,3,3,2,10,4,22,0
6274,73,83790,0,0,81,1076,16,417,42,48,16,1615,1,8,10,6,3,28,1
1655,42,34350,1,0,81,16,3,15,2,1,11,48,1,1,0,3,7,12,0
2740,63,33438,1,1,81,62,1,16,3,2,6,90,4,2,1,4,5,16,0
4328,35,21955,1,0,81,5,1,7,17,14,11,55,2,2,1,3,6,14,0
17,50,60491,0,1,81,637,47,237,12,19,76,1028,4,6,11,7,5,33,0
9153,57,59304,0,1,81,418,61,428,80,51,10,1048,3,7,8,10,5,33,0
520,47,34421,1,0,81,3,3,7,6,2,9,30,1,1,0,2,7,11,0
8372,47,34421,1,0,81,3,3,7,6,2,9,30,1,1,0,2,7,11,0
73,68,51411,1,2,81,14,0,3,0,0,1,18,1,0,0,3,5,9,0
2002,63,71964,0,0,81,587,51,932,180,34,86,1870,1,5,6,5,3,20,0
6059,68,64504,1,2,81,986,36,168,16,0,108,1314,7,11,3,4,7,32,0
11166,60,49678,0,1,81,229,5,56,3,2,20,315,2,6,2,4,7,21,0
6257,45,60482,0,1,81,255,43,134,37,14,24,507,1,7,2,7,7,24,0
9224,49,55260,0,1,81,825,8,53,11,0,242,1139,2,8,10,5,6,31,0
8732,52,67369,0,1,81,1298,0,70,37,14,42,1461,4,7,4,10,4,29,1
955,59,47175,1,1,81,167,2,44,6,2,19,240,7,4,2,4,8,25,1
4910,54,68743,0,0,81,1132,134,384,175,134,115,2074,1,11,5,13,7,37,0
564,40,56937,1,0,81,746,8,125,11,8,8,906,7,8,6,9,6,36,1
8931,35,83033,1,0,82,812,99,431,237,149,33,1761,1,11,4,10,5,31,1
1998,45,37697,1,0,82,34,6,21,11,4,8,84,1,2,1,3,6,13,0
1250,45,37697,1,0,82,34,6,21,11,4,8,84,1,2,1,3,6,13,0
8397,70,44689,1,1,82,18,0,5,0,0,11,34,2,1,1,2,7,13,1
9672,51,23162,1,1,82,8,3,9,19,4,22,65,3,1,1,3,6,14,0
2125,62,63033,0,0,82,194,61,480,225,112,30,1102,1,3,4,8,2,18,0
5975,54,40304,1,0,82,37,0,17,0,0,3,57,1,2,0,3,7,13,0
983,37,40059,1,0,82,110,29,92,28,10,145,414,1,6,2,3,8,20,1
9938,67,80067,0,0,82,519,17,813,27,173,51,1600,1,4,6,6,2,19,1
4385,40,36038,1,0,82,23,0,15,0,2,7,47,2,3,0,3,6,14,0
803,53,40521,1,1,82,12,0,5,0,0,4,21,1,0,1,2,5,9,0
10675,65,66334,0,1,82,909,11,218,0,0,23,1161,2,9,3,5,5,24,0
7004,37,11012,1,0,82,24,3,26,7,1,23,84,3,3,1,2,9,18,1
4432,45,31615,1,0,82,2,3,20,6,11,9,51,2,2,0,3,7,14,0
4475,72,69098,0,0,82,1315,22,780,145,0,178,2440,1,7,8,9,5,30,0
10868,70,70792,0,0,82,344,45,654,104,11,114,1272,2,3,4,10,3,22,0
6742,42,17688,1,0,82,2,2,1,3,1,2,11,1,1,0,2,8,12,0
5692,32,25443,1,0,82,1,4,3,8,9,7,32,1,1,0,3,8,13,0
339,49,57091,0,1,82,462,0,24,6,0,4,496,2,9,2,5,7,25,1
10398,40,24336,1,0,82,1,6,2,8,2,12,31,1,1,0,2,7,11,0
8017,40,51111,1,1,83,22,0,19,6,5,3,55,2,2,0,3,6,13,0
3722,49,44503,1,1,83,31,1,8,0,0,8,48,2,2,0,3,6,13,0
7326,50,56850,0,1,83,34,1,19,2,7,0,63,1,1,1,3,2,8,0
2416,52,66582,0,0,83,789,25,420,16,38,0,1288,1,2,8,9,1,21,0
1878,36,23148,0,0,83,4,6,8,6,3,10,37,1,2,0,3,7,13,0
5278,57,82224,0,0,83,307,26,360,138,31,40,902,1,6,9,5,3,24,1
5734,47,61917,1,1,83,46,4,36,2,2,1,91,1,2,0,4,5,12,0
4370,55,43482,2,1,83,18,1,32,6,3,28,88,3,2,0,4,6,15,0
8405,42,68274,1,1,83,135,25,51,23,25,46,305,2,4,2,5,3,16,0
7617,47,42373,1,1,83,67,5,61,3,8,19,163,5,2,1,5,5,18,0
6376,42,57537,1,0,83,191,56,139,51,8,100,545,4,4,3,8,4,23,0
2150,63,80995,0,1,83,860,28,409,73,56,56,1482,1,8,9,4,4,26,0
7386,45,30992,1,0,83,17,0,14,7,3,2,43,1,1,0,3,7,12,0
3006,45,30992,1,0,83,17,0,14,7,3,2,43,1,1,0,3,7,12,0
11088,50,78642,0,1,83,1396,0,322,46,35,17,1816,1,4,9,4,6,24,0
5185,66,74268,0,0,83,199,66,315,97,174,41,892,1,4,3,5,2,15,0
3523,59,75072,0,1,83,583,34,309,0,22,125,1073,2,5,4,8,3,22,0
55,58,56253,0,1,83,509,0,65,7,11,5,597,4,7,2,9,6,28,0
3807,66,59925,0,1,83,473,21,176,19,21,56,766,3,9,2,9,6,29,0
2453,61,62807,0,1,83,526,28,135,10,21,99,819,3,5,3,12,5,28,0
7787,61,62807,0,1,83,526,28,135,10,21,99,819,3,5,3,12,5,28,0
2230,51,23626,1,0,84,27,2,14,0,0,0,43,3,3,1,3,5,15,0
8146,45,46106,1,1,84,30,0,8,2,0,14,54,1,1,1,2,6,11,0
988,56,81168,0,0,84,410,0,592,147,22,22,1193,1,6,4,7,3,21,1
4832,42,27244,1,0,84,6,5,17,3,24,46,101,2,2,2,2,7,15,0
3152,64,26091,1,1,84,15,10,19,8,17,20,89,3,2,1,3,5,14,0
11188,64,26091,1,1,84,15,10,19,8,17,20,89,3,2,1,3,5,14,0
361,52,43142,1,1,84,5,1,7,2,1,4,20,1,1,0,2,7,11,0
5939,50,38232,1,1,84,43,5,28,7,6,33,122,4,3,1,3,5,16,0
9349,36,92533,0,0,84,693,21,118,110,147,42,1131,1,6,5,11,2,25,1
819,76,63285,0,0,84,508,124,249,50,38,134,1103,1,6,5,13,3,28,0
10120,66,38946,0,1,84,116,6,82,6,6,41,257,2,3,1,6,5,17,0
4541,66,38946,0,1,84,116,6,82,6,6,41,257,2,3,1,6,5,17,0
2456,46,40233,0,1,84,80,4,46,0,17,2,149,5,2,1,5,6,19,0
2516,52,46831,1,1,84,22,2,10,6,4,34,78,2,1,2,2,4,11,0
11013,34,67605,0,0,84,336,28,282,184,54,54,938,1,2,8,6,1,18,0
9988,45,70379,0,1,84,553,25,142,65,67,8,860,3,6,3,13,4,29,0
1627,64,77297,0,0,84,408,61,109,48,122,41,789,1,5,7,9,4,26,1
1490,59,55759,0,1,84,675,0,85,10,7,77,854,5,10,3,8,8,34,0
6710,70,58217,2,1,84,68,1,13,3,5,13,103,1,2,0,4,6,13,0
7375,45,51369,0,1,84,297,7,79,0,11,182,576,2,8,2,4,8,24,0
10144,45,51369,0,1,84,297,7,79,0,11,182,576,2,8,2,4,8,24,0
3138,65,91249,0,0,84,1324,27,119,71,108,27,1676,0,7,9,6,4,26,1
1440,43,52513,0,0,84,367,17,241,104,188,232,1149,2,9,5,9,7,32,0
4200,51,44159,1,0,85,167,2,62,24,13,7,275,4,4,1,6,5,20,0
4998,59,76081,0,0,85,292,30,415,63,33,200,1033,1,4,5,4,2,16,1
7321,59,76081,0,0,85,292,30,415,63,33,200,1033,1,4,5,4,2,16,1
8663,47,39996,1,1,85,11,0,3,0,0,1,15,1,1,0,2,6,10,0
1958,48,55012,0,1,85,582,0,65,0,0,13,660,6,8,2,9,5,30,0
6963,74,77457,0,0,85,675,11,400,15,45,11,1157,1,2,5,10,1,19,1
1065,58,80695,0,0,85,557,129,984,193,37,18,1918,1,5,8,5,2,21,0
2712,65,71866,0,1,85,184,178,178,103,39,33,715,1,6,3,10,3,23,0
6049,39,73450,0,0,85,1142,51,415,90,69,37,1804,1,7,8,11,3,30,1
6605,77,55614,0,0,85,504,13,131,8,0,26,682,1,9,4,6,7,27,1
11181,72,156924,0,0,85,2,1,2,1,1,1,8,0,0,0,0,0,0,0
5234,54,30753,1,1,85,12,5,25,0,9,30,81,2,1,1,3,5,12,0
5253,65,54603,1,1,85,145,13,46,17,2,4,227,6,4,2,4,7,23,0
11148,46,22280,1,0,85,2,1,4,3,1,2,13,1,1,0,2,8,12,0
6289,70,59385,1,1,85,135,0,10,0,4,36,185,2,3,1,4,5,15,0
9743,66,76998,0,1,85,1449,89,161,69,35,107,1910,2,11,8,8,6,35,1
9209,50,80573,0,0,85,829,138,430,60,92,15,1564,1,4,6,13,2,26,0
6417,50,80573,0,0,85,829,138,430,60,92,15,1564,1,4,6,13,2,26,0
7937,39,24711,0,0,86,10,7,25,6,3,7,58,1,3,0,3,7,14,0
6488,62,38829,0,1,86,76,0,7,0,0,16,99,1,3,2,2,5,13,0
3194,47,71466,0,0,86,412,12,546,78,182,0,1230,1,4,4,10,1,20,0
231,65,28839,1,1,86,24,0,7,0,0,1,32,2,2,0,3,5,12,0
9697,70,53790,0,2,86,335,42,127,28,5,5,542,3,7,2,8,6,26,0
4676,70,73705,0,2,86,612,91,520,258,107,107,1695,2,9,6,8,5,30,0
8079,39,22448,1,0,86,3,1,8,23,2,18,55,3,2,1,3,3,12,0
10032,45,12571,1,0,86,3,5,14,2,12,17,53,4,3,1,3,6,17,0
10505,61,73113,0,0,86,741,19,154,50,9,28,1001,1,3,4,7,2,17,0
2005,31,35765,1,0,86,22,3,30,0,5,15,75,2,2,0,4,6,14,0
6940,55,46734,1,2,86,100,1,39,6,1,76,223,4,3,2,3,6,18,1
2304,58,66313,0,1,86,625,7,99,10,22,7,770,2,6,3,12,4,27,0
3170,64,68148,0,0,86,389,66,408,37,57,85,1042,1,4,4,6,2,17,0
10466,56,44393,1,1,86,24,2,20,2,2,10,60,2,1,0,4,4,11,0
7325,35,38197,1,0,86,23,0,11,2,1,3,40,1,1,0,3,5,10,0
455,75,51012,0,0,86,102,9,63,2,9,24,209,1,4,1,4,6,16,0
7592,75,51012,0,0,86,102,9,63,2,9,24,209,1,4,1,4,6,16,0
4547,61,13672,1,1,86,6,2,9,2,1,5,25,2,1,0,3,8,14,0
6825,68,41452,1,1,86,13,0,3,0,0,0,16,1,1,0,2,7,11,0
2961,39,42081,1,0,86,175,10,110,54,6,27,382,2,6,3,4,6,21,1
8700,35,14906,0,0,86,7,7,14,7,16,15,66,3,2,1,3,7,16,0
2278,36,33812,1,0,86,4,17,19,30,24,39,133,2,2,1,3,6,14,0
10703,46,46098,1,1,86,57,0,27,0,0,36,120,4,3,2,2,8,19,0
9,46,46098,1,1,86,57,0,27,0,0,36,120,4,3,2,2,8,19,0
2804,46,46098,1,1,86,57,0,27,0,0,36,120,4,3,2,2,8,19,0
4915,65,53230,0,1,86,176,72,98,136,21,229,732,4,5,2,12,5,28,0
3010,32,88420,0,0,87,957,153,612,99,95,153,2069,1,4,7,8,1,21,1
4279,58,39548,1,1,87,15,4,10,3,4,18,54,2,1,1,3,3,10,0
2564,68,61278,0,1,87,111,3,28,2,6,15,165,2,3,1,4,6,16,0
1137,57,81246,0,0,87,398,190,537,61,156,37,1379,1,4,5,7,1,18,1
5084,46,58330,0,1,87,445,53,213,104,98,151,1064,1,6,4,13,4,28,0
7094,46,58330,0,1,87,445,53,213,104,98,151,1064,1,6,4,13,4,28,0
6327,54,65777,0,0,87,565,32,435,28,32,54,1146,1,2,8,6,1,18,0
6131,41,70829,1,1,87,141,70,106,72,19,23,431,2,4,2,8,3,19,0
10379,59,59247,0,2,87,327,9,122,19,14,83,574,5,5,2,9,6,27,0
606,54,25930,1,1,87,6,1,2,2,0,4,15,1,1,0,2,7,11,0
7801,62,54753,0,1,87,197,107,227,7,59,131,728,3,5,2,11,4,25,0
2445,47,28440,1,0,87,38,1,24,0,0,0,63,1,2,0,3,8,14,0
5346,48,23559,1,0,87,25,5,19,7,0,23,79,3,3,0,3,7,16,0
550,69,62335,0,1,87,243,131,217,85,6,26,708,2,3,3,13,2,23,0
4478,42,63777,1,1,87,457,5,106,15,17,53,653,8,11,1,6,8,34,0
2350,49,59666,1,1,87,623,53,178,23,17,133,1027,7,3,2,8,8,28,1
1118,65,50965,0,1,87,544,13,85,8,6,29,685,3,10,4,5,8,30,1
1491,56,71488,0,0,87,162,33,124,40,28,172,559,2,3,4,7,1,17,0
4507,69,72228,0,0,87,631,28,491,30,14,56,1250,1,6,7,8,3,25,0
7023,68,46231,2,1,87,189,2,55,0,5,12,263,4,6,1,4,9,24,0
6977,47,75702,0,1,87,1073,0,629,145,37,37,1921,1,10,5,13,6,35,1
4042,50,43300,0,1,87,91,3,52,2,1,31,180,3,4,0,4,8,19,0
7274,64,78618,0,0,87,736,163,818,212,163,61,2153,1,4,7,10,2,24,1
3332,36,29760,1,0,87,64,4,68,7,5,17,165,4,3,1,4,8,20,0
7433,36,29760,1,0,87,64,4,68,7,5,17,165,4,3,1,4,8,20,0
9386,59,50127,0,1,88,274,0,21,4,6,15,320,1,5,1,6,6,19,1
5176,33,29604,1,0,88,7,6,13,7,6,14,53,1,1,0,3,9,14,1
10323,69,49413,0,1,88,205,7,41,3,2,46,304,2,4,2,5,5,18,0
4682,63,51876,0,0,88,99,27,102,28,48,6,310,1,2,2,8,1,14,0
3083,47,45837,1,1,88,215,13,87,17,17,24,373,5,6,2,5,7,25,0
8015,59,85696,0,0,88,714,76,395,116,0,12,1313,1,4,6,9,1,21,0
1745,59,85696,0,0,88,714,76,395,116,0,12,1313,1,4,6,9,1,21,0
3136,59,59432,0,1,88,317,25,265,25,19,12,663,3,5,3,11,5,27,0
6991,70,43185,0,1,88,537,6,42,16,6,30,637,2,9,3,6,8,28,0
8132,46,60631,1,1,88,565,6,65,0,6,19,661,5,9,2,8,7,31,1
503,36,20559,1,0,88,13,1,29,3,0,7,53,2,2,0,3,8,15,0
8148,65,50898,1,1,88,285,28,242,55,114,135,859,13,6,2,12,5,38,0
2736,43,73807,0,1,88,366,124,156,71,78,54,849,2,5,5,11,2,25,0
8162,65,14661,0,0,88,4,1,11,6,2,2,26,1,1,0,3,6,11,0
692,67,36807,1,1,88,4,2,5,0,0,5,16,1,1,0,2,6,10,0
7706,46,46772,0,1,88,350,104,189,197,151,57,1048,6,11,8,5,8,38,1
9298,74,81574,0,0,89,1252,0,465,46,35,0,1798,1,4,5,8,1,19,1
2986,45,30772,1,1,89,7,2,4,2,1,4,20,1,1,0,2,6,10,0
10812,43,46377,1,0,89,37,0,46,4,3,0,90,1,2,1,3,4,11,0
2909,47,78128,0,1,89,934,24,230,16,24,36,1264,2,8,4,6,3,23,1
6974,49,83443,0,0,89,518,42,742,55,56,84,1497,1,6,10,5,2,24,0
9140,61,50523,1,1,89,51,4,24,4,7,1,91,2,2,0,4,6,14,0
4554,56,47009,0,1,89,171,45,73,59,10,90,448,4,3,2,8,4,21,0
7791,54,37054,1,1,89,12,1,6,0,1,5,25,2,1,0,3,7,13,0
5455,50,32011,1,0,89,99,0,15,2,1,5,122,3,2,1,4,7,17,0
7960,59,82122,0,0,89,734,22,350,151,25,100,1382,1,3,9,13,1,27,1
3426,46,70300,1,0,89,1045,61,338,60,46,46,1596,3,5,5,13,8,34,0
5316,45,21024,0,0,89,36,4,18,6,2,18,84,1,2,0,4,7,14,0
1404,53,34916,2,0,89,51,23,82,33,0,42,231,4,5,1,3,9,22,0
10598,54,27943,1,1,89,12,1,16,4,1,3,37,3,2,0,3,8,16,0
8212,50,39791,0,1,89,85,15,27,13,13,21,174,2,3,1,4,7,17,0
3233,56,62745,0,1,89,562,21,464,28,10,32,1117,3,7,8,11,5,34,0
7892,52,18589,0,0,89,6,4,25,15,12,13,75,2,2,1,3,7,15,0
2975,45,85606,0,1,89,717,42,864,219,30,84,1956,2,6,7,9,3,27,1
5043,70,26997,0,0,89,7,23,78,133,49,144,434,2,4,2,5,7,20,0
3104,60,82332,0,0,89,830,59,968,51,79,19,2006,1,5,3,12,2,23,1
10854,51,38853,1,1,90,29,0,14,0,0,2,45,2,2,0,3,7,14,0
7419,53,27071,1,0,90,8,3,19,0,2,3,35,2,2,0,3,6,13,0
5558,67,90933,0,0,90,1020,31,430,62,63,79,1685,1,4,6,4,1,16,1
832,55,65814,0,1,90,561,14,113,10,14,35,747,3,8,2,10,5,28,0
4964,63,74250,0,0,90,680,11,392,75,0,0,1158,1,2,11,4,1,19,0
11030,45,33181,1,0,90,9,0,3,0,0,4,16,1,1,0,2,6,10,1
4587,77,45006,0,0,90,162,25,53,16,0,10,266,1,3,1,7,3,15,0
450,63,42315,0,1,90,67,15,80,17,11,80,270,3,1,4,4,3,15,0
11031,71,48699,1,1,90,26,1,10,2,0,1,40,1,1,0,3,5,10,0
4990,67,59111,0,0,90,524,0,134,28,28,155,869,1,11,1,8,7,28,0
221,66,48726,0,1,90,138,3,38,4,0,59,242,3,3,2,4,6,18,0
4351,66,37244,1,1,90,18,2,10,0,0,25,55,1,1,1,2,7,12,1
1357,51,74854,1,2,90,856,59,487,58,29,73,1562,7,2,5,5,5,24,0
5667,57,60896,0,1,90,1013,30,399,60,46,153,1701,3,9,10,4,6,32,0
8867,33,67546,0,0,90,864,134,768,150,38,172,2126,1,4,10,5,3,23,0
2747,33,67546,0,0,90,864,134,768,150,38,172,2126,1,4,10,5,3,23,0
7422,34,46923,1,0,90,85,44,54,102,78,6,369,3,5,1,7,7,23,0
4148,49,38988,1,2,90,164,24,103,12,3,42,348,7,5,1,6,8,27,0
9516,50,49118,0,0,90,620,54,239,99,98,119,1229,2,9,7,10,7,35,1
1291,43,27683,1,0,90,152,9,121,12,12,45,351,4,6,2,4,8,24,0
1833,47,39190,1,0,91,68,8,18,19,8,12,133,2,2,1,4,5,14,0
7270,40,56981,0,0,91,908,48,217,32,12,24,1241,1,2,3,13,6,25,1
8182,37,23228,1,0,91,53,3,49,7,4,5,121,4,3,0,4,8,19,0
10394,37,90000,0,0,91,675,144,133,94,192,241,1479,1,4,8,5,1,19,1
1142,68,55707,0,1,91,208,7,82,30,66,35,428,2,3,2,9,3,19,0
451,32,9255,1,0,91,9,0,7,2,0,4,22,1,1,1,2,8,13,0
7128,44,42997,1,1,91,4,0,5,0,1,5,15,1,1,0,2,7,11,0
10678,62,71232,0,1,91,653,17,170,34,26,17,917,2,11,2,10,7,32,0
7755,67,57744,0,1,91,350,3,39,0,0,19,411,2,9,1,4,8,24,0
4754,55,33585,0,1,91,30,11,33,13,6,29,122,1,2,0,4,4,11,0
20,56,46891,0,1,91,43,12,23,29,15,61,183,1,2,1,4,4,12,0
2246,56,46891,0,1,91,43,12,23,29,15,61,183,1,2,1,4,4,12,0
10307,65,50387,0,2,91,369,9,87,12,14,34,525,3,6,2,8,5,24,0
2147,52,76653,0,0,91,736,63,946,219,189,126,2279,1,4,7,11,2,25,1
10590,65,76542,0,0,91,794,73,573,0,29,14,1483,1,4,8,10,2,25,0
6565,72,76995,0,1,91,1012,80,498,0,16,176,1782,2,11,4,9,5,31,1
6619,43,38415,1,1,91,22,1,13,4,0,4,44,2,1,0,3,7,13,0
4817,65,22304,0,0,91,3,2,7,0,4,2,18,1,1,0,2,8,12,0
4508,69,75127,0,0,92,203,35,305,46,17,227,833,1,2,11,5,1,20,0
4843,69,75127,0,0,92,203,35,305,46,17,227,833,1,2,11,5,1,20,0
9197,68,39722,0,1,92,32,0,5,2,0,8,47,2,2,0,3,5,12,0
6237,55,7144,0,2,92,81,4,33,5,2,291,416,0,23,1,1,0,25,0
6515,44,39771,1,0,92,6,2,18,2,8,14,50,1,2,0,3,4,10,0
5954,49,42618,1,0,92,76,14,74,13,5,10,192,2,5,0,4,8,19,0
7938,63,51518,0,1,92,350,8,66,17,4,4,449,2,3,2,10,3,20,0
961,49,74716,0,1,92,133,27,421,13,195,71,860,2,7,3,5,4,21,0
1764,46,33955,1,0,92,100,2,128,23,7,10,270,4,5,1,5,8,23,0
1916,67,45736,0,1,92,188,3,180,20,3,43,437,5,7,1,6,7,26,0
6941,50,31632,0,0,92,17,8,12,11,15,32,95,1,2,1,2,7,13,0
5562,47,60093,0,1,92,502,12,109,16,6,90,735,2,7,2,10,6,27,0
1517,52,30822,1,0,92,3,9,13,2,12,12,51,1,1,0,3,7,12,0
7286,53,41728,1,0,92,13,6,15,3,5,13,55,1,2,0,2,10,15,0
4687,63,80739,0,0,92,674,92,736,39,0,92,1633,1,3,11,9,1,25,0
5631,30,49767,0,0,92,202,47,197,55,42,149,692,1,5,4,8,4,22,0
1951,40,34445,0,0,92,228,122,122,208,129,30,839,6,11,2,8,9,36,0
123,70,67046,0,1,92,544,35,133,23,151,107,993,2,4,5,4,2,17,0
9451,56,73538,0,1,92,811,76,428,99,137,107,1658,3,10,4,9,7,33,0
7396,55,80398,0,0,92,342,51,936,207,35,26,1597,1,5,8,12,3,29,1
3298,65,52973,0,1,92,856,0,76,12,9,199,1152,7,9,6,9,8,39,0
6730,67,38998,1,1,92,34,1,14,0,0,5,54,3,2,0,3,8,16,0
9916,67,38998,1,1,92,34,1,14,0,0,5,54,3,2,0,3,8,16,0
2227,63,26490,0,0,92,45,47,52,21,20,25,210,2,3,1,5,6,17,0
946,63,26490,0,0,92,45,47,52,21,20,25,210,2,3,1,5,6,17,0
3745,33,23331,1,0,92,5,36,7,0,10,45,103,2,3,0,3,8,16,0
4094,60,60544,1,1,92,201,2,43,3,5,35,289,4,5,1,5,6,21,0
8588,60,60544,1,1,92,201,2,43,3,5,35,289,4,5,1,5,6,21,0
3916,50,49269,1,0,92,639,8,166,11,8,58,890,3,7,3,12,7,32,0
9135,71,27203,1,1,92,13,2,21,4,0,24,64,2,1,1,2,8,14,0
1755,33,45204,1,0,93,30,11,25,29,1,18,114,1,1,1,4,3,10,0
2875,43,67023,0,0,93,444,44,382,11,8,17,906,1,3,7,13,2,26,0
2008,43,77583,0,0,93,372,23,384,250,12,108,1149,1,4,5,9,2,21,1
10925,38,76630,0,0,93,255,31,446,40,56,175,1003,1,3,10,11,1,26,0
1604,61,47353,0,1,93,184,2,19,8,8,4,225,3,2,2,6,5,18,0
5389,57,48920,0,2,93,238,17,68,8,10,6,347,3,6,2,5,7,23,1
2878,74,67472,0,1,93,162,31,127,8,17,69,414,2,4,2,7,3,18,0
4440,57,64100,0,1,93,509,0,27,0,0,10,546,1,8,3,6,7,25,1
1324,33,38872,1,0,93,23,3,21,3,19,22,91,2,3,0,3,8,16,0
6262,59,72217,0,0,93,816,42,450,55,56,154,1573,1,3,10,8,2,24,0
3628,34,15038,1,0,93,4,8,11,19,12,26,80,2,2,1,2,9,16,0
3641,45,13624,1,0,93,10,2,15,2,1,6,36,2,2,0,3,6,13,0
322,43,42554,1,1,93,29,1,11,0,0,0,41,2,2,0,3,4,11,0
175,35,71952,1,0,93,656,80,455,52,107,93,1443,2,8,4,8,4,26,1
6988,35,71952,1,0,93,656,80,455,52,107,93,1443,2,8,4,8,4,26,1
8204,50,78041,0,0,93,482,35,553,72,160,17,1319,1,4,4,9,2,20,0
7476,57,63972,0,1,93,928,63,254,0,12,12,1269,4,5,4,10,4,27,1
5221,64,52852,0,1,93,714,8,99,11,0,47,879,4,10,7,5,8,34,1
8970,49,62010,0,1,93,371,22,39,6,0,92,530,4,6,2,7,5,24,0
9286,61,83151,0,0,93,407,28,100,120,74,18,747,1,5,9,4,3,22,0
5831,54,77870,0,1,93,1017,50,500,65,50,133,1815,3,5,5,5,8,26,1
1010,44,46931,2,1,94,41,0,17,3,1,16,78,2,1,1,3,3,10,0
11074,44,85072,0,0,94,494,92,391,194,11,241,1423,1,3,4,10,0,18,0
5896,34,73395,0,0,94,272,7,80,20,7,11,397,1,4,4,6,2,17,0
3515,69,62307,0,1,94,87,13,34,10,6,10,160,1,4,0,4,5,14,0
5324,40,58293,1,0,94,173,43,118,46,27,15,422,5,5,3,6,5,24,0
6534,47,47889,1,0,94,29,0,29,0,5,4,67,1,2,0,3,5,11,0
8373,42,24594,1,0,94,1,3,6,10,0,9,29,1,1,0,3,5,10,0
3829,42,24594,1,0,94,1,3,6,10,0,9,29,1,1,0,3,5,10,0
4501,56,69882,0,0,94,292,127,635,132,127,165,1478,1,3,7,9,1,21,0
4179,62,24221,0,0,94,8,9,9,2,5,22,55,1,1,1,3,4,10,0
2292,36,22327,1,0,94,5,4,8,2,0,5,24,1,1,0,3,5,10,0
9239,60,61923,0,2,94,92,4,18,3,3,6,126,1,2,1,4,3,11,0
8953,56,35791,2,1,94,27,0,5,0,0,3,35,2,1,0,3,8,14,0
10258,56,35791,2,1,94,27,0,5,0,0,3,35,2,1,0,3,8,14,0
3520,31,91172,0,0,94,162,28,818,0,28,56,1092,0,4,3,7,3,17,1
10402,54,35441,1,1,94,25,1,9,2,1,1,39,2,1,0,3,8,14,0
11114,51,19656,1,0,94,25,4,9,6,8,32,84,3,2,1,3,7,16,0
9553,34,7500,0,0,94,0,2,3,4,1,5,15,1,0,0,3,6,10,0
6055,42,71626,0,0,94,546,72,376,94,145,72,1305,1,5,5,8,3,22,1
4786,44,75330,1,1,94,555,82,257,93,61,61,1109,4,10,3,12,6,35,0
5015,45,34529,1,0,94,68,6,38,3,6,41,162,2,2,2,3,7,16,0
8560,29,48789,0,0,94,351,16,156,7,5,145,680,1,6,4,7,6,24,0
3469,44,34487,1,1,94,19,18,33,24,1,8,103,3,3,0,3,9,18,0
5885,48,35688,2,1,94,73,3,90,12,1,32,211,7,4,1,4,8,24,0
3310,48,35688,2,1,94,73,3,90,12,1,32,211,7,4,1,4,8,24,0
2134,69,53700,0,1,94,263,5,233,69,41,83,694,4,5,5,8,5,27,0
2532,34,73454,0,0,95,982,73,351,56,14,175,1651,1,2,4,6,5,18,1
2579,64,71113,0,1,95,495,33,255,11,33,8,835,4,6,7,9,4,30,0
5623,41,31535,1,0,95,15,4,13,0,0,19,51,1,1,1,2,7,12,1
4789,68,80812,0,0,95,769,22,500,210,143,33,1677,1,4,8,5,2,20,1
9523,39,40479,1,0,95,5,0,8,2,0,0,15,1,0,0,3,4,8,0
5268,61,29440,1,1,95,17,8,14,10,4,3,56,2,1,0,4,7,14,0
1545,35,38508,1,0,95,120,19,206,25,19,54,443,6,7,2,5,8,28,0
2254,38,69520,0,0,95,627,120,414,121,80,93,1455,1,9,6,5,5,26,0
2661,57,18701,1,1,95,12,4,2,10,6,10,44,4,2,0,4,5,15,0
3130,57,18701,1,1,95,12,4,2,10,6,10,44,4,2,0,4,5,15,0
5847,52,69901,0,1,95,312,21,206,102,92,149,882,3,7,3,10,5,28,0
5863,68,47703,0,1,95,359,0,134,13,26,123,655,4,6,3,8,5,26,0
999,30,86037,0,0,95,490,44,125,29,20,22,730,1,6,7,11,3,28,1
2931,43,71847,0,0,95,737,21,106,55,63,210,1192,0,6,7,9,3,25,1
1890,50,42033,1,1,95,11,1,4,2,0,7,25,1,1,0,2,7,11,0
5589,57,51983,0,1,95,631,0,115,10,7,30,793,3,9,2,10,7,31,0
10172,33,68655,0,0,95,456,19,832,75,118,38,1538,1,4,5,11,3,24,0
6729,33,68655,0,0,95,456,19,832,75,118,38,1538,1,4,5,11,3,24,0
10492,62,38285,2,1,96,2,0,5,2,0,1,10,1,0,0,3,2,6,0
2939,51,79419,0,0,96,751,127,687,20,15,31,1631,1,4,6,4,2,17,0
5948,46,57338,0,1,96,143,6,52,11,8,17,237,2,4,1,5,5,17,0
574,57,42523,0,0,96,14,36,11,3,26,35,125,1,1,1,4,2,9,0
3266,57,42523,0,0,96,14,36,11,3,26,35,125,1,1,1,4,2,9,0
10500,37,31761,1,0,96,19,1,20,16,14,28,98,2,3,0,4,5,14,0
7987,52,65747,0,1,96,346,17,48,23,13,13,460,4,8,1,6,6,25,1
1135,61,17144,1,1,96,18,2,19,0,2,6,47,5,3,0,4,7,19,0
24,61,17144,1,1,96,18,2,19,0,2,6,47,5,3,0,4,7,19,0
1966,56,84618,0,0,96,684,100,801,21,66,0,1672,1,6,9,10,2,28,1
7789,56,84618,0,0,96,684,100,801,21,66,0,1672,1,6,9,10,2,28,1
3336,73,66375,0,1,96,712,0,45,0,0,191,948,3,2,4,5,7,21,1
5644,64,42213,0,1,96,309,3,24,4,3,20,363,2,5,1,7,7,22,1
6663,81,51141,0,0,96,144,0,7,0,0,6,157,1,3,1,4,5,14,0
10262,41,15072,2,0,96,8,2,15,0,10,18,53,4,3,1,3,5,16,0
456,35,7500,1,0,96,1,11,5,4,6,9,36,2,2,0,3,8,15,0
3270,43,17117,1,0,96,12,23,38,30,18,7,128,4,3,1,3,9,20,0
5748,56,59754,0,1,96,115,27,44,4,146,139,475,3,5,2,6,5,21,0
8952,68,65569,0,1,96,397,46,288,20,38,70,859,2,6,5,10,3,26,0
3921,69,28457,0,0,96,24,1,108,29,29,14,205,1,4,1,4,8,18,0
9826,49,86857,0,0,96,899,102,838,133,102,40,2114,1,5,6,10,2,24,0
5830,49,86857,0,0,96,899,102,838,133,102,40,2114,1,5,6,10,2,24,0
8310,57,68142,0,1,96,897,126,196,91,112,37,1459,3,10,4,7,6,30,0
6382,68,48794,1,1,97,25,0,11,3,0,15,54,1,1,0,3,4,9,0
8439,57,63404,0,2,97,734,26,70,11,44,17,902,2,6,3,4,4,19,1
7613,47,49669,1,0,97,166,5,107,11,8,29,326,2,5,1,6,6,20,0
48,57,55761,0,1,97,136,1,12,0,3,32,184,2,4,1,3,6,16,1
5046,63,78331,0,1,97,756,138,354,160,169,61,1638,2,10,6,7,4,29,0
3231,48,37971,1,0,97,5,4,10,2,2,7,30,1,1,0,3,8,13,0
7181,44,30368,0,1,97,35,0,13,2,0,2,52,2,2,0,3,8,15,0
1663,43,34043,1,0,97,20,2,14,3,0,10,49,1,2,0,2,9,14,0
5441,56,54111,0,1,97,267,6,54,8,3,50,388,2,5,2,6,5,20,0
8602,57,69932,0,1,97,412,172,153,150,105,57,1049,2,7,6,11,4,30,0
9925,40,39665,1,0,97,127,1,56,0,1,31,216,3,4,2,3,7,19,1
9499,67,93404,1,2,97,1279,15,287,20,0,15,1616,3,3,4,7,5,22,1
6568,37,38680,1,0,97,11,0,36,15,5,12,79,1,2,0,3,7,13,0
3032,37,24570,1,0,97,28,34,62,11,14,44,193,3,4,0,4,9,20,0
5153,54,77766,0,1,97,1004,59,265,115,59,27,1529,2,11,10,11,6,40,1
4127,54,77766,0,1,97,1004,59,265,115,59,27,1529,2,11,10,11,6,40,1
9940,63,64961,0,1,97,382,114,276,75,124,38,1009,2,6,4,4,3,19,0
7527,53,23748,1,0,97,6,6,29,12,15,8,76,3,2,1,3,8,17,0
3406,57,45989,0,1,97,138,33,87,28,24,12,322,4,3,2,7,3,19,0
9771,33,23331,1,0,97,104,20,101,24,15,5,269,6,5,1,5,9,26,0
6722,67,70421,0,1,98,479,28,136,75,14,35,767,3,10,3,7,6,29,0
213,58,23091,1,1,98,35,0,11,0,0,2,48,4,2,1,3,7,17,0
8541,31,24683,1,0,98,8,4,10,6,7,6,41,2,2,0,4,5,13,0
8475,48,157243,0,1,98,20,2,1582,1,2,1,1608,15,0,22,0,0,37,0
8070,48,54222,0,1,98,199,12,31,3,12,7,264,1,3,3,5,3,15,0
313,53,73455,0,0,98,901,61,757,186,163,20,2088,1,6,5,10,3,25,1
9757,49,84906,0,0,98,997,15,414,99,30,76,1631,1,5,6,12,2,26,1
2088,49,84906,0,0,98,997,15,414,99,30,76,1631,1,5,6,12,2,26,1
2320,43,47025,0,1,98,508,11,59,23,5,29,635,5,11,1,6,9,32,0
966,55,44529,0,1,98,538,13,91,17,6,26,691,6,6,2,11,5,30,1
9706,47,31560,1,0,98,62,1,20,4,0,7,94,2,2,1,3,8,16,0
3979,38,90687,0,0,98,982,17,672,23,34,51,1779,1,6,2,8,2,19,1
5602,32,66973,0,0,98,466,22,432,147,113,102,1282,1,8,7,12,3,31,0
2202,43,41154,0,1,98,44,2,11,2,3,7,69,1,1,0,4,5,11,0
9645,53,64590,0,0,98,920,138,168,36,46,30,1338,1,9,4,10,6,30,0
7230,61,50611,0,1,98,459,0,24,6,0,4,493,6,4,5,7,6,28,1
5675,61,50611,0,1,98,459,0,24,6,0,4,493,6,4,5,7,6,28,1
4974,51,83273,1,2,98,433,89,650,16,102,102,1392,10,4,6,9,7,36,0
5687,41,81702,0,0,98,563,50,774,28,31,187,1633,1,7,7,12,3,30,0
5871,42,24401,0,0,98,73,28,217,10,24,115,467,3,6,1,6,8,24,0
3846,47,42557,0,1,98,192,5,53,0,5,15,270,4,6,1,4,8,23,0
10001,36,7500,1,0,98,5,17,17,13,14,34,100,4,2,1,3,9,19,0
2831,45,78416,0,1,99,453,38,279,188,38,183,1179,2,7,7,10,3,29,0
868,55,44794,0,1,99,54,0,7,0,0,4,65,1,2,0,3,6,12,0
7212,55,44794,0,1,99,54,0,7,0,0,4,65,1,2,0,3,6,12,0
1743,47,69719,0,0,99,273,86,208,177,14,43,801,1,2,3,5,1,12,0
2415,59,62568,0,1,99,362,17,398,80,35,61,953,3,5,3,5,4,20,1
7947,52,42231,1,1,99,24,0,8,0,1,4,37,1,1,0,3,5,10,0
2106,47,20130,0,0,99,0,6,3,7,6,12,34,1,1,0,3,8,13,0
3363,47,20130,0,0,99,0,6,3,7,6,12,34,1,1,0,3,8,13,0
8595,48,42429,0,1,99,55,0,6,2,0,4,67,2,1,1,3,5,12,0
7232,48,42429,0,1,99,55,0,6,2,0,4,67,2,1,1,3,5,12,0
7829,121,36640,1,0,99,15,6,8,7,4,25,65,1,2,1,2,5,11,0
9977,48,78901,0,1,99,321,11,309,33,26,34,734,3,9,3,5,4,24,0
10142,45,66476,0,1,99,372,18,126,47,48,78,689,2,5,2,11,4,24,0
5263,44,31056,1,0,99,5,10,13,3,8,16,55,1,1,0,3,8,13,0
22,45,46310,1,0,99,185,2,88,15,5,14,309,2,6,1,5,8,22,0
528,43,65819,0,0,99,267,38,701,149,165,63,1383,1,5,4,10,3,23,0
4070,52,94871,0,2,99,169,24,553,188,0,144,1078,1,8,5,4,7,25,1
